i	j	i_id	j_id	r_sco	s_sco	prob	distance
603	606	603_Q	606_Q	1.8384	4.338	1	3
343	346	343_Q	346_K	1.8297	4.318	1	3
497	500	497_N	500_A	1.7857	4.214	1	3
306	309	306_E	309_K	1.7796	4.2	1	3
642	645	642_D	645_Q	1.7736	4.185	1	3
269	272	269_Q	272_D	1.771	4.179	1	3
571	574	571_N	574_Q	1.7389	4.104	1	3
381	384	381_Q	384_I	1.6944	3.998	1	3
718	721	718_K	721_E	1.6698	3.94	1	3
536	539	536_N	539_N	1.6664	3.932	1	3
755	758	755_N	758_A	1.6616	3.921	1	3
419	422	419_R	422_D	1.6585	3.914	1	3
678	681	678_M	681_T	1.3477	3.18	1	3
458	461	458_N	461_F	1.2464	2.941	1	3
185	188	185_N	188_Q	1.1457	2.704	1	3
222	235	222_T	235_K	1.1443	2.7	1	13
595	611	595_A	611_S	1.0205	2.408	1	16
298	314	298_A	314_Y	0.9709	2.291	1	16
634	650	634_F	650_L	0.9454	2.231	1	16
335	351	335_A	351_I	0.9372	2.212	1	16
261	277	261_L	277_M	0.9371	2.211	1	16
489	505	489_V	505_K	0.9246	2.182	1	16
411	427	411_A	427_L	0.9112	2.15	1	16
257	276	257_L	276_T	0.8676	2.047	1	19
747	763	747_A	763_L	0.8441	1.992	1	16
608	612	608_I	612_K	0.8345	1.969	1	4
598	606	598_L	606_Q	0.8274	1.952	1	8
485	504	485_L	504_Y	0.8248	1.946	1	19
563	579	563_L	579_I	0.8227	1.942	1	16
710	726	710_L	726_L	0.8163	1.926	1	16
591	610	591_G	610_I	0.8129	1.918	1	19
373	389	373_A	389_Y	0.8095	1.91	1	16
594	610	594_K	610_I	0.8056	1.901	1	16
706	725	706_E	725_V	0.804	1.897	1	19
260	264	260_M	264_Y	0.7996	1.887	1	4
723	727	723_L	727_T	0.7954	1.877	1	4
294	313	294_K	313_I	0.7943	1.874	1	19
528	544	528_L	544_F	0.7913	1.867	1	16
315	334	315_E	334_L	0.7853	1.853	1	19
297	301	297_Y	301_I	0.7726	1.823	1	4
633	649	633_Q	649_I	0.7725	1.823	1	16
386	390	386_A	390_E	0.7597	1.793	1	4
637	645	637_L	645_Q	0.7581	1.789	1	8
334	350	334_L	350_Y	0.7581	1.789	1	16
372	376	372_L	376_F	0.7525	1.776	1	4
331	350	331_A	350_Y	0.7496	1.769	1	19
580	594	580_D	594_K	0.7473	1.763	1	14
274	278	274_E	278_S	0.7437	1.755	1	4
407	426	407_L	426_Y	0.7419	1.751	1	19
278	297	278_S	297_Y	0.7415	1.75	1	19
334	338	334_L	338_L	0.7386	1.743	0.999	4
576	580	576_L	580_D	0.7354	1.735	0.999	4
311	315	311_V	315_E	0.735	1.734	0.999	4
594	598	594_K	598_L	0.7303	1.723	0.999	4
743	762	743_L	762_S	0.73	1.723	0.999	19
606	609	606_Q	609_K	0.7246	1.71	0.999	3
492	500	492_Y	500_A	0.7233	1.707	0.999	8
369	388	369_S	388_I	0.7225	1.705	0.999	19
424	428	424_K	428_D	0.7161	1.69	0.999	4
264	276	264_Y	276_T	0.716	1.69	0.999	12
348	352	348_I	352_N	0.7134	1.684	0.999	4
346	349	346_K	349_E	0.7128	1.682	0.999	3
488	504	488_D	504_Y	0.709	1.673	0.999	16
260	276	260_M	276_T	0.7049	1.663	0.999	16
301	313	301_I	313_I	0.7044	1.662	0.999	12
500	503	500_A	503_A	0.7032	1.659	0.999	3
709	725	709_Y	725_V	0.7006	1.653	0.999	16
338	346	338_L	346_K	0.7001	1.652	0.999	8
630	649	630_Y	649_I	0.6963	1.643	0.999	19
352	372	352_N	372_L	0.6922	1.634	0.999	20
502	506	502_L	506_D	0.6917	1.632	0.999	4
376	388	376_F	388_I	0.69	1.628	0.999	12
390	410	390_E	410_L	0.6894	1.627	0.999	20
647	651	647_I	651_Q	0.6859	1.619	0.999	4
598	603	598_L	603_Q	0.6817	1.609	0.999	5
612	633	612_K	633_Q	0.6798	1.604	0.999	21
713	721	713_L	721_E	0.6784	1.601	0.999	8
410	414	410_L	414_L	0.6762	1.596	0.999	4
301	309	301_I	309_K	0.6754	1.594	0.999	8
746	750	746_Q	750_Y	0.6735	1.589	0.999	4
414	419	414_L	419_R	0.6703	1.582	0.998	5
562	566	562_M	566_L	0.6702	1.582	0.998	4
272	275	272_D	275_Y	0.6695	1.58	0.998	3
297	313	297_Y	313_I	0.6674	1.575	0.998	16
709	713	709_Y	713_L	0.664	1.567	0.998	4
713	718	713_L	718_K	0.6634	1.565	0.998	5
746	762	746_Q	762_S	0.6606	1.559	0.998	16
384	387	384_I	387_S	0.6548	1.545	0.998	3
524	543	524_A	543_I	0.6542	1.544	0.998	19
633	637	633_Q	637_L	0.6539	1.543	0.998	4
376	384	376_F	384_I	0.6516	1.538	0.998	8
750	758	750_Y	758_A	0.6491	1.532	0.998	8
264	269	264_Y	269_Q	0.6446	1.521	0.998	5
314	333	314_Y	333_S	0.6436	1.519	0.998	19
422	425	422_D	425_K	0.6431	1.518	0.998	3
541	545	541_A	545_M	0.6395	1.509	0.997	4
721	724	721_E	724_A	0.6384	1.507	0.997	3
727	746	727_T	746_Q	0.6383	1.506	0.997	19
261	280	261_L	280_L	0.6378	1.505	0.997	19
613	616	613_D	616_N	0.6363	1.501	0.997	3
592	632	592_L	632_L	0.6335	1.495	0.997	40
645	648	645_Q	648_K	0.633	1.494	0.997	3
309	312	309_K	312_N	0.6313	1.49	0.997	3
527	543	527_D	543_I	0.6286	1.483	0.997	16
566	574	566_L	574_Q	0.6265	1.478	0.997	8
670	686	670_L	686_A	0.6262	1.478	0.997	16
372	388	372_L	388_I	0.6237	1.472	0.997	16
467	488	467_T	488_D	0.6237	1.472	0.997	21
611	632	611_S	632_L	0.6223	1.469	0.997	21
506	527	506_D	527_D	0.6171	1.456	0.996	21
492	504	492_Y	504_Y	0.6166	1.455	0.996	12
574	577	574_Q	577_D	0.6165	1.455	0.996	3
566	571	566_L	571_N	0.6157	1.453	0.996	5
213	217	213_K	217_Q	0.6157	1.453	0.996	4
598	610	598_L	610_I	0.6141	1.449	0.996	12
264	272	264_Y	272_D	0.6119	1.444	0.996	8
414	422	414_L	422_D	0.6109	1.442	0.996	8
338	350	338_L	350_Y	0.6109	1.442	0.996	12
301	306	301_I	306_E	0.6102	1.44	0.996	5
728	731	728_D	731_K	0.6012	1.419	0.995	3
652	655	652_I	655_S	0.6009	1.418	0.995	3
760	764	760_K	764_K	0.5983	1.412	0.995	4
376	381	376_F	381_Q	0.5962	1.407	0.995	5
277	296	277_M	296_D	0.5917	1.396	0.995	19
637	642	637_L	642_D	0.5857	1.382	0.994	5
750	762	750_Y	762_S	0.5856	1.382	0.994	12
758	761	758_A	761_E	0.5843	1.379	0.994	3
527	531	527_D	531_A	0.5836	1.377	0.994	4
338	343	338_L	343_Q	0.5782	1.365	0.993	5
488	492	488_D	492_Y	0.5763	1.36	0.993	4
562	578	562_M	578_Y	0.5751	1.357	0.993	16
613	617	613_D	617_S	0.5728	1.352	0.993	4
637	649	637_L	649_I	0.5725	1.351	0.993	12
750	755	750_Y	755_N	0.5678	1.34	0.992	5
539	542	539_N	542_N	0.5676	1.339	0.992	3
389	409	389_Y	409_D	0.5672	1.338	0.992	20
237	241	237_I	241_K	0.5662	1.336	0.992	4
351	371	351_I	371_E	0.5577	1.316	0.991	20
652	656	652_I	656_F	0.557	1.314	0.991	4
595	614	595_A	614_I	0.5536	1.306	0.99	19
194	213	194_Q	213_K	0.5523	1.303	0.99	19
710	729	710_L	729_L	0.552	1.303	0.99	19
728	732	728_D	732_L	0.5499	1.298	0.989	4
316	319	316_N	319_F	0.5494	1.296	0.989	3
747	766	747_A	766_C	0.5458	1.288	0.989	19
559	578	559_K	578_Y	0.5451	1.286	0.989	19
463	467	463_H	467_T	0.5439	1.283	0.988	4
531	539	531_A	539_N	0.5403	1.275	0.988	8
214	240	214_L	240_A	0.5402	1.275	0.988	26
414	426	414_L	426_Y	0.539	1.272	0.987	12
545	562	545_M	562_M	0.5357	1.264	0.987	17
531	543	531_A	543_I	0.5353	1.263	0.987	12
576	597	576_L	597_I	0.5346	1.262	0.987	21
707	745	707_F	745_I	0.5333	1.258	0.986	38
177	193	177_I	193_A	0.5331	1.258	0.986	16
612	616	612_K	616_N	0.5331	1.258	0.986	4
298	317	298_A	317_T	0.5311	1.253	0.986	19
274	304	274_E	304_L	0.5291	1.249	0.985	30
683	687	683_L	687_P	0.5287	1.248	0.985	4
386	410	386_A	410_L	0.5265	1.243	0.985	24
373	392	373_A	392_A	0.524	1.236	0.984	19
411	430	411_A	430_Y	0.5228	1.234	0.984	19
723	746	723_L	746_Q	0.5224	1.233	0.984	23
295	330	295_L	330_A	0.5205	1.228	0.983	35
370	406	370_L	406_T	0.5203	1.228	0.983	36
608	640	608_I	640_L	0.5202	1.228	0.983	32
634	653	634_F	653_L	0.5185	1.223	0.982	19
410	426	410_L	426_Y	0.5182	1.223	0.982	16
681	684	681_T	684_T	0.5159	1.217	0.982	3
608	633	608_I	633_Q	0.5135	1.212	0.981	25
492	497	492_Y	497_N	0.5128	1.21	0.981	5
311	334	311_V	334_L	0.5113	1.207	0.98	23
489	508	489_V	508_I	0.5088	1.201	0.98	19
581	585	581_K	585_E	0.5083	1.2	0.979	4
348	375	348_I	375_L	0.5081	1.199	0.979	27
579	593	579_I	593_Q	0.5078	1.198	0.979	14
279	282	279_I	282_N	0.5078	1.198	0.979	3
448	466	448_D	466_Y	0.5073	1.197	0.979	18
337	341	337_N	341_N	0.5061	1.194	0.979	4
505	526	505_K	526_N	0.5052	1.192	0.978	21
486	523	486_D	523_A	0.5033	1.188	0.978	37
723	749	723_L	749_T	0.5024	1.186	0.977	26
429	433	429_L	433_D	0.5024	1.186	0.977	4
254	280	254_S	280_L	0.5024	1.186	0.977	26
461	464	461_F	464_Q	0.5023	1.185	0.977	3
335	354	335_A	354_I	0.5011	1.183	0.977	19
241	260	241_K	260_M	0.4998	1.179	0.976	19
190	194	190_V	194_Q	0.4996	1.179	0.976	4
608	636	608_I	636_S	0.4987	1.177	0.976	28
673	681	673_A	681_T	0.4985	1.176	0.976	8
581	584	581_K	584_N	0.497	1.173	0.975	3
386	417	386_A	417_A	0.4957	1.17	0.975	31
180	185	180_E	185_N	0.4913	1.159	0.973	5
729	742	729_L	742_A	0.4905	1.157	0.973	13
727	731	727_T	731_K	0.4903	1.157	0.973	4
726	745	726_L	745_I	0.4892	1.154	0.972	19
573	601	573_E	601_N	0.489	1.154	0.972	28
614	629	614_I	629_A	0.4881	1.152	0.972	15
235	238	235_K	238_D	0.488	1.152	0.972	3
242	245	242_N	245_R	0.4878	1.151	0.972	3
352	356	352_N	356_K	0.4863	1.148	0.971	4
576	601	576_L	601_N	0.4861	1.147	0.971	25
258	293	258_H	293_S	0.4835	1.141	0.97	35
669	673	669_L	673_A	0.4829	1.139	0.969	4
699	702	699_N	702_S	0.4827	1.139	0.969	3
262	266	262_R	266_A	0.4806	1.134	0.968	4
257	279	257_L	279_I	0.4803	1.134	0.968	22
279	283	279_I	283_E	0.4761	1.124	0.966	4
213	239	213_K	239_D	0.4745	1.12	0.965	26
485	507	485_L	507_L	0.4718	1.113	0.963	22
744	748	744_Y	748_L	0.4717	1.113	0.963	4
386	413	386_A	413_V	0.4706	1.11	0.963	27
588	614	588_I	614_I	0.4695	1.108	0.962	26
566	578	566_L	578_Y	0.4689	1.107	0.962	12
188	191	188_Q	191_I	0.4684	1.105	0.961	3
311	338	311_V	338_L	0.4675	1.103	0.961	27
271	304	271_A	304_L	0.4674	1.103	0.961	33
221	233	221_Y	233_L	0.4672	1.102	0.961	12
563	582	563_L	582_N	0.4662	1.1	0.96	19
370	409	370_L	409_D	0.4655	1.099	0.96	39
596	632	596_S	632_L	0.4652	1.098	0.96	36
751	763	751_E	763_L	0.4615	1.089	0.957	12
651	655	651_Q	655_S	0.4611	1.088	0.957	4
608	637	608_I	637_L	0.4611	1.088	0.957	29
507	510	507_L	510_S	0.4607	1.087	0.956	3
706	728	706_E	728_D	0.4599	1.085	0.956	22
580	584	580_D	584_N	0.4593	1.084	0.956	4
447	465	447_S	465_R	0.4587	1.083	0.955	18
489	501	489_V	501_I	0.4587	1.082	0.955	12
428	447	428_D	447_S	0.458	1.081	0.955	19
673	678	673_A	678_M	0.4578	1.08	0.954	5
366	392	366_I	392_A	0.4577	1.08	0.954	26
490	494	490_A	494_K	0.4571	1.079	0.954	4
591	613	591_G	613_D	0.4571	1.079	0.954	22
502	531	502_L	531_A	0.4566	1.077	0.954	29
447	451	447_S	451_F	0.4565	1.077	0.954	4
348	372	348_I	372_L	0.4561	1.076	0.953	24
328	354	328_A	354_I	0.4544	1.072	0.952	26
713	725	713_L	725_V	0.4543	1.072	0.952	12
765	768	765_Q	768_E	0.4538	1.071	0.952	3
263	267	263_T	267_L	0.4534	1.07	0.951	4
560	590	560_K	590_Y	0.4527	1.068	0.951	30
274	297	274_E	297_Y	0.4522	1.067	0.95	23
311	341	311_V	341_N	0.45	1.062	0.949	30
332	368	332_M	368_R	0.4494	1.061	0.948	36
404	430	404_E	430_Y	0.4486	1.059	0.948	26
373	385	373_A	385_S	0.4481	1.058	0.947	12
648	652	648_K	652_I	0.4475	1.056	0.947	4
348	379	348_I	379_K	0.4461	1.053	0.946	31
425	429	425_K	429_L	0.446	1.053	0.946	4
386	414	386_A	414_L	0.4458	1.052	0.945	28
720	753	720_E	753_M	0.4454	1.051	0.945	33
531	536	531_A	536_N	0.4435	1.046	0.943	5
576	594	576_L	594_K	0.4431	1.046	0.943	18
284	287	284_Q	287_N	0.4431	1.046	0.943	3
308	341	308_E	341_N	0.4431	1.046	0.943	33
280	293	280_L	293_S	0.4418	1.043	0.942	13
486	526	486_D	526_N	0.4404	1.039	0.94	40
576	598	576_L	598_L	0.4375	1.033	0.938	22
193	212	193_A	212_Y	0.4371	1.032	0.938	19
723	753	723_L	753_M	0.4368	1.031	0.937	30
383	417	383_D	417_A	0.4368	1.031	0.937	34
604	636	604_Y	636_S	0.4353	1.027	0.936	32
210	239	210_I	239_D	0.4349	1.026	0.935	29
466	487	466_Y	487_E	0.4348	1.026	0.935	21
274	301	274_E	301_I	0.4325	1.021	0.933	27
703	729	703_P	729_L	0.4303	1.015	0.931	26
634	646	634_F	646_A	0.4301	1.015	0.931	12
485	508	485_L	508_I	0.4291	1.013	0.93	23
614	617	614_I	617_S	0.4287	1.012	0.929	3
636	640	636_S	640_L	0.4279	1.01	0.928	4
407	429	407_L	429_L	0.4278	1.01	0.928	22
302	307	302_Y	307_K	0.4276	1.009	0.928	5
468	471	468_D	471_K	0.427	1.008	0.927	3
723	750	723_L	750_Y	0.4269	1.007	0.927	27
595	607	595_A	607_V	0.4269	1.007	0.927	12
299	333	299_D	333_S	0.4263	1.006	0.926	34
560	593	560_K	593_Q	0.4257	1.005	0.926	33
499	534	499_S	534_A	0.4254	1.004	0.926	35
524	546	524_A	546_R	0.4254	1.004	0.926	22
274	300	274_E	300_Y	0.4251	1.003	0.925	26
469	472	469_L	472_Q	0.4241	1.001	0.924	3
730	743	730_L	743_L	0.4239	1	0.924	13
707	711	707_F	711_D	0.4231	0.998	0.923	4
388	392	388_I	392_A	0.4227	0.997	0.922	4
200	203	200_Y	203_S	0.4224	0.997	0.922	3
331	354	331_A	354_I	0.4223	0.997	0.922	23
258	296	258_H	296_D	0.4222	0.996	0.922	38
612	645	612_K	645_Q	0.4222	0.996	0.922	33
528	540	528_L	540_A	0.422	0.996	0.922	12
638	650	638_L	650_L	0.4215	0.995	0.921	12
339	351	339_L	351_I	0.4194	0.99	0.919	12
504	507	504_Y	507_L	0.419	0.989	0.918	3
391	395	391_D	395_K	0.4187	0.988	0.918	4
564	593	564_A	593_Q	0.4185	0.988	0.918	29
714	726	714_T	726_L	0.4183	0.987	0.917	12
763	767	763_L	767_L	0.4183	0.987	0.917	4
345	379	345_N	379_K	0.4177	0.986	0.917	34
375	379	375_L	379_K	0.4176	0.985	0.916	4
261	276	261_L	276_T	0.4173	0.985	0.916	15
335	347	335_A	347_A	0.4167	0.983	0.915	12
317	330	317_T	330_A	0.4159	0.981	0.914	13
331	353	331_A	353_T	0.4157	0.981	0.914	22
353	356	353_T	356_K	0.4157	0.981	0.914	3
240	259	240_A	259_I	0.4148	0.979	0.913	19
765	769	765_Q	769_I	0.4148	0.979	0.913	4
411	423	411_A	423_A	0.4147	0.979	0.913	12
666	685	666_Y	685_Y	0.4147	0.979	0.913	19
311	337	311_V	337_N	0.4146	0.978	0.912	26
429	432	429_L	432_D	0.4141	0.977	0.912	3
299	303	299_D	303_N	0.4139	0.977	0.912	4
349	353	349_E	353_T	0.4138	0.976	0.911	4
724	728	724_A	728_D	0.4134	0.976	0.911	4
630	653	630_Y	653_L	0.4133	0.975	0.911	23
294	316	294_K	316_N	0.4128	0.974	0.91	22
482	508	482_N	508_I	0.4121	0.973	0.909	26
712	716	712_A	716_I	0.4121	0.973	0.909	4
609	612	609_K	612_K	0.4114	0.971	0.908	3
295	333	295_L	333_S	0.41	0.968	0.907	38
374	409	374_K	409_D	0.4098	0.967	0.906	35
350	353	350_Y	353_T	0.4095	0.966	0.905	3
257	280	257_L	280_L	0.4089	0.965	0.905	23
217	222	217_Q	222_T	0.4085	0.964	0.904	5
348	376	348_I	376_F	0.4083	0.963	0.904	28
408	412	408_K	412_L	0.408	0.963	0.904	4
711	745	711_D	745_I	0.4078	0.962	0.903	34
740	766	740_A	766_C	0.4074	0.961	0.902	26
564	568	564_A	568_R	0.4068	0.96	0.902	4
388	391	388_I	391_D	0.4054	0.957	0.9	3
711	726	711_D	726_L	0.4053	0.956	0.899	15
313	317	313_I	317_T	0.4052	0.956	0.899	4
747	762	747_A	762_S	0.405	0.956	0.899	15
421	425	421_S	425_K	0.4048	0.955	0.899	4
294	317	294_K	317_T	0.404	0.953	0.897	23
532	544	532_I	544_F	0.4035	0.952	0.897	12
502	530	502_L	530_N	0.4025	0.95	0.896	28
743	766	743_L	766_C	0.4014	0.947	0.894	23
605	640	605_P	640_L	0.4012	0.947	0.894	35
467	471	467_T	471_K	0.4008	0.946	0.893	4
316	320	316_N	320_N	0.4004	0.945	0.892	4
722	726	722_S	726_L	0.3996	0.943	0.891	4
195	198	195_N	198_N	0.3991	0.942	0.89	3
468	472	468_D	472_Q	0.399	0.941	0.89	4
250	253	250_D	253_F	0.3988	0.941	0.89	3
688	691	688_K	691_D	0.3988	0.941	0.89	3
541	566	541_A	566_L	0.3976	0.938	0.888	25
743	765	743_L	765_Q	0.396	0.934	0.885	22
596	611	596_S	611_S	0.3958	0.934	0.885	15
582	585	582_N	585_E	0.3957	0.934	0.885	3
595	610	595_A	610_I	0.3953	0.933	0.884	15
507	511	507_L	511_K	0.3944	0.931	0.883	4
762	765	762_S	765_Q	0.3942	0.93	0.882	3
258	262	258_H	262_R	0.3941	0.93	0.882	4
463	488	463_H	488_D	0.3936	0.929	0.881	25
764	768	764_K	768_E	0.393	0.927	0.88	4
265	277	265_I	277_M	0.3911	0.923	0.877	12
377	413	377_N	413_V	0.3911	0.923	0.877	36
187	220	187_N	220_L	0.3908	0.922	0.876	33
525	561	525_I	561_Q	0.3902	0.921	0.875	36
464	468	464_Q	468_D	0.39	0.92	0.875	4
298	310	298_A	310_A	0.3894	0.919	0.874	12
599	611	599_F	611_S	0.389	0.918	0.873	12
318	331	318_Y	331_A	0.389	0.918	0.873	13
572	597	572_V	597_I	0.3889	0.918	0.873	25
489	504	489_V	504_Y	0.3885	0.917	0.872	15
490	526	490_A	526_N	0.388	0.915	0.871	36
596	600	596_S	600_D	0.3879	0.915	0.871	4
302	337	302_Y	337_N	0.3877	0.915	0.871	35
315	319	315_E	319_F	0.3876	0.915	0.871	4
591	614	591_G	614_I	0.3872	0.914	0.87	23
544	561	544_F	561_Q	0.387	0.913	0.869	17
313	316	313_I	316_N	0.3867	0.913	0.869	3
377	389	377_N	389_Y	0.3864	0.912	0.869	12
747	759	747_A	759_E	0.3851	0.909	0.866	12
682	686	682_I	686_A	0.3851	0.909	0.866	4
275	279	275_Y	279_I	0.3848	0.908	0.865	4
190	216	190_V	216_A	0.3845	0.907	0.865	26
415	427	415_S	427_L	0.3839	0.906	0.864	12
567	593	567_I	593_Q	0.3832	0.904	0.862	26
502	527	502_L	527_D	0.3825	0.903	0.861	25
377	382	377_N	382_F	0.3823	0.902	0.86	5
687	691	687_P	691_D	0.3823	0.902	0.86	4
391	394	391_D	394_A	0.3817	0.901	0.86	3
382	413	382_F	413_V	0.3815	0.9	0.859	31
369	391	369_S	391_D	0.3811	0.899	0.858	22
609	613	609_K	613_D	0.3808	0.899	0.858	4
465	468	465_R	468_D	0.3808	0.899	0.858	3
369	392	369_S	392_A	0.3807	0.898	0.857	23
350	354	350_Y	354_I	0.3807	0.898	0.857	4
180	188	180_E	188_Q	0.3804	0.898	0.857	8
276	279	276_T	279_I	0.38	0.897	0.856	3
559	581	559_K	581_K	0.3798	0.896	0.855	22
298	313	298_A	313_I	0.379	0.894	0.854	15
724	727	724_A	727_T	0.379	0.894	0.854	3
390	394	390_E	394_A	0.3788	0.894	0.854	4
759	763	759_E	763_L	0.3785	0.893	0.853	4
270	300	270_R	300_Y	0.3785	0.893	0.853	30
493	505	493_Y	505_K	0.3778	0.892	0.852	12
727	758	727_T	758_A	0.3777	0.891	0.851	31
370	374	370_L	374_K	0.3771	0.89	0.85	4
428	432	428_D	432_D	0.3771	0.89	0.85	4
577	581	577_D	581_K	0.3767	0.889	0.849	4
761	765	761_E	765_Q	0.3757	0.887	0.848	4
310	314	310_A	314_Y	0.3754	0.886	0.847	4
615	629	615_A	629_A	0.3749	0.885	0.846	14
702	705	702_S	705_L	0.3749	0.885	0.846	3
541	569	541_A	569_T	0.3744	0.883	0.844	28
627	653	627_F	653_L	0.3743	0.883	0.844	26
312	316	312_N	316_N	0.3739	0.882	0.843	4
653	656	653_L	656_F	0.3732	0.881	0.842	3
592	596	592_L	596_S	0.3727	0.88	0.841	4
607	611	607_V	611_S	0.3726	0.879	0.84	4
332	371	332_M	371_E	0.3723	0.879	0.84	39
608	642	608_I	642_D	0.3719	0.878	0.839	34
506	510	506_D	510_S	0.3719	0.878	0.839	4
302	314	302_Y	314_Y	0.3718	0.877	0.839	12
180	192	180_E	192_D	0.3717	0.877	0.839	12
355	368	355_L	368_R	0.3711	0.876	0.838	13
725	728	725_V	728_D	0.3707	0.875	0.837	3
749	753	749_T	753_M	0.3705	0.874	0.836	4
710	722	710_L	722_S	0.3696	0.872	0.834	12
667	708	667_D	708_I	0.3688	0.87	0.832	41
318	330	318_Y	330_A	0.3683	0.869	0.831	12
276	280	276_T	280_L	0.3681	0.869	0.831	4
194	198	194_Q	198_N	0.367	0.866	0.828	4
196	209	196_A	209_F	0.3666	0.865	0.827	13
630	652	630_Y	652_I	0.3665	0.865	0.827	22
217	239	217_Q	239_D	0.3664	0.865	0.827	22
300	304	300_Y	304_L	0.3663	0.864	0.826	4
714	752	714_T	752_R	0.366	0.864	0.826	38
528	547	528_L	547_F	0.3657	0.863	0.825	19
216	220	216_A	220_L	0.3653	0.862	0.824	4
708	711	708_I	711_D	0.3649	0.861	0.823	3
610	613	610_I	613_D	0.3646	0.86	0.822	3
393	406	393_F	406_T	0.364	0.859	0.821	13
261	273	261_L	273_V	0.3637	0.858	0.82	12
648	651	648_K	651_Q	0.3631	0.857	0.819	3
650	668	650_L	668_A	0.3628	0.856	0.818	18
413	417	413_V	417_A	0.3626	0.856	0.818	4
392	406	392_A	406_T	0.3625	0.855	0.817	14
473	476	473_Y	476_K	0.3623	0.855	0.817	3
592	629	592_L	629_A	0.3619	0.854	0.816	37
503	506	503_A	506_D	0.3619	0.854	0.816	3
336	340	336_K	340_S	0.3619	0.854	0.816	4
528	543	528_L	543_I	0.3619	0.854	0.816	15
333	336	333_S	336_K	0.3614	0.853	0.815	3
707	742	707_F	742_A	0.3613	0.853	0.815	35
499	503	499_S	503_A	0.3603	0.85	0.812	4
739	742	739_R	742_A	0.3602	0.85	0.812	3
190	213	190_V	213_K	0.3601	0.85	0.812	23
634	649	634_F	649_I	0.36	0.849	0.811	15
651	681	651_Q	681_T	0.3599	0.849	0.811	30
387	391	387_S	391_D	0.3598	0.849	0.811	4
332	336	332_M	336_K	0.3591	0.847	0.809	4
615	630	615_A	630_Y	0.3584	0.846	0.808	15
486	490	486_D	490_A	0.3581	0.845	0.807	4
265	296	265_I	296_D	0.3577	0.844	0.805	31
503	507	503_A	507_L	0.3566	0.841	0.802	4
344	375	344_V	375_L	0.3564	0.841	0.802	31
211	215	211_L	215_R	0.3563	0.841	0.802	4
278	282	278_S	282_N	0.3551	0.838	0.799	4
730	742	730_L	742_A	0.3543	0.836	0.797	12
573	577	573_E	577_D	0.3533	0.834	0.795	4
335	350	335_A	350_Y	0.3532	0.833	0.793	15
336	371	336_K	371_E	0.3529	0.833	0.793	35
563	575	563_L	575_A	0.3528	0.833	0.793	12
353	357	353_T	357_A	0.3524	0.832	0.792	4
770	773	770_K	773_S	0.3523	0.831	0.791	3
626	629	626_N	629_A	0.3522	0.831	0.791	3
671	675	671_S	675_D	0.3519	0.83	0.79	4
354	368	354_I	368_R	0.3518	0.83	0.79	14
604	640	604_Y	640_L	0.3512	0.829	0.789	36
407	430	407_L	430_Y	0.3506	0.827	0.787	23
587	590	587_S	590_Y	0.3491	0.824	0.783	3
307	337	307_K	337_N	0.3486	0.823	0.782	30
721	725	721_E	725_V	0.3484	0.822	0.781	4
347	375	347_A	375_L	0.3477	0.82	0.778	28
605	609	605_P	609_K	0.3471	0.819	0.777	4
371	374	371_E	374_K	0.3471	0.819	0.777	3
212	215	212_Y	215_R	0.347	0.819	0.777	3
563	578	563_L	578_Y	0.347	0.819	0.777	15
295	299	295_L	299_D	0.3469	0.819	0.777	4
541	565	541_A	565_C	0.3466	0.818	0.776	24
631	635	631_Y	635_L	0.3461	0.817	0.775	4
422	426	422_D	426_Y	0.346	0.816	0.774	4
237	263	237_I	263_T	0.3456	0.816	0.774	26
723	755	723_L	755_N	0.345	0.814	0.771	32
425	503	425_K	503_A	0.3448	0.814	0.771	78
355	372	355_L	372_L	0.3448	0.814	0.771	17
719	753	719_N	753_M	0.3446	0.813	0.77	34
599	636	599_F	636_S	0.3442	0.812	0.769	37
360	620	360_E	620_L	0.344	0.812	0.769	260
714	719	714_T	719_N	0.3435	0.811	0.768	5
714	749	714_T	749_T	0.3431	0.81	0.766	35
311	343	311_V	343_Q	0.3427	0.809	0.765	32
383	387	383_D	387_S	0.3426	0.808	0.764	4
623	626	623_D	626_N	0.3426	0.808	0.764	3
647	676	647_I	676_H	0.3424	0.808	0.764	29
181	193	181_Y	193_A	0.3422	0.807	0.763	12
315	346	315_E	346_K	0.3418	0.807	0.763	31
745	748	745_I	748_L	0.3411	0.805	0.76	3
237	267	237_I	267_L	0.3408	0.804	0.759	30
412	416	412_L	416_H	0.3398	0.802	0.756	4
281	294	281_D	294_K	0.3397	0.802	0.756	13
197	209	197_I	209_F	0.3396	0.801	0.755	12
271	275	271_A	275_Y	0.3395	0.801	0.755	4
358	361	358_N	361_Y	0.3385	0.799	0.752	3
234	267	234_E	267_L	0.3379	0.797	0.75	33
191	194	191_I	194_Q	0.3377	0.797	0.75	3
261	296	261_L	296_D	0.3366	0.794	0.746	35
501	505	501_I	505_K	0.336	0.793	0.745	4
597	601	597_I	601_N	0.3359	0.793	0.745	4
751	756	751_E	756_I	0.335	0.79	0.741	5
309	313	309_K	313_I	0.3344	0.789	0.739	4
385	413	385_S	413_V	0.3342	0.789	0.739	28
726	730	726_L	730_L	0.3341	0.789	0.739	4
649	652	649_I	652_I	0.3341	0.788	0.738	3
191	195	191_I	195_N	0.3336	0.787	0.737	4
190	220	190_V	220_L	0.3334	0.787	0.737	30
275	278	275_Y	278_S	0.3333	0.787	0.737	3
195	199	195_N	199_R	0.333	0.786	0.735	4
321	324	321_T	324_L	0.3329	0.786	0.735	3
262	277	262_R	277_M	0.3326	0.785	0.734	15
236	240	236_M	240_A	0.3324	0.784	0.733	4
632	635	632_L	635_L	0.3324	0.784	0.733	3
393	407	393_F	407_L	0.3317	0.783	0.731	14
339	378	339_L	378_Q	0.3314	0.782	0.73	39
679	682	679_Q	682_I	0.3314	0.782	0.73	3
352	384	352_N	384_I	0.3308	0.781	0.729	32
726	749	726_L	749_T	0.3302	0.779	0.726	23
710	725	710_L	725_V	0.3302	0.779	0.726	15
217	235	217_Q	235_K	0.33	0.779	0.726	18
646	650	646_A	650_L	0.3299	0.779	0.726	4
310	337	310_A	337_N	0.3298	0.778	0.725	27
463	492	463_H	492_Y	0.3294	0.777	0.723	29
179	183	179_K	183_K	0.3288	0.776	0.722	4
576	603	576_L	603_Q	0.3285	0.775	0.721	27
446	449	446_A	449_E	0.3283	0.775	0.721	3
299	314	299_D	314_Y	0.3278	0.774	0.719	15
418	496	418_N	496_G	0.3277	0.773	0.718	78
192	196	192_D	196_A	0.3275	0.773	0.718	4
354	357	354_I	357_A	0.3272	0.772	0.716	3
463	495	463_H	495_E	0.3269	0.771	0.715	32
538	542	538_I	542_N	0.3262	0.77	0.714	4
301	304	301_I	304_L	0.3261	0.77	0.714	3
573	576	573_E	576_L	0.3256	0.768	0.711	3
565	569	565_C	569_T	0.3252	0.767	0.709	4
638	643	638_L	643_Y	0.3252	0.767	0.709	5
635	650	635_L	650_L	0.3251	0.767	0.709	15
302	333	302_Y	333_S	0.3247	0.766	0.708	31
711	714	711_D	714_T	0.3244	0.766	0.708	3
460	464	460_S	464_Q	0.3238	0.764	0.705	4
543	546	543_I	546_R	0.3237	0.764	0.705	3
599	604	599_F	604_Y	0.3237	0.764	0.705	5
502	534	502_L	534_A	0.3233	0.763	0.704	32
542	546	542_N	546_R	0.3224	0.761	0.701	4
192	195	192_D	195_N	0.3218	0.759	0.698	3
762	766	762_S	766_C	0.3217	0.759	0.698	4
525	529	525_I	529_K	0.3217	0.759	0.698	4
758	762	758_A	762_S	0.3216	0.759	0.698	4
529	561	529_K	561_Q	0.3215	0.759	0.698	32
280	283	280_L	283_E	0.3214	0.758	0.696	3
339	371	339_L	371_E	0.3212	0.758	0.696	32
706	729	706_E	729_L	0.321	0.758	0.696	23
234	238	234_E	238_D	0.3207	0.757	0.695	4
529	533	529_K	533_K	0.3202	0.756	0.694	4
398	620	398_K	620_L	0.3198	0.755	0.692	222
291	317	291_Q	317_T	0.3197	0.754	0.691	26
631	668	631_Y	668_A	0.3196	0.754	0.691	37
424	447	424_K	447_S	0.3193	0.753	0.689	23
612	637	612_K	637_L	0.3192	0.753	0.689	25
711	715	711_D	715_K	0.319	0.753	0.689	4
764	767	764_K	767_L	0.3188	0.752	0.688	3
242	246	242_N	246_T	0.3187	0.752	0.688	4
409	412	409_D	412_L	0.3186	0.752	0.688	3
580	606	580_D	606_Q	0.318	0.75	0.685	26
599	632	599_F	632_L	0.3177	0.75	0.685	33
542	545	542_N	545_M	0.3175	0.749	0.683	3
241	245	241_K	245_R	0.3174	0.749	0.683	4
575	579	575_A	579_I	0.3169	0.748	0.682	4
729	732	729_L	732_L	0.3169	0.748	0.682	3
510	616	510_S	616_N	0.3168	0.748	0.682	106
668	671	668_A	671_S	0.3168	0.748	0.682	3
748	763	748_L	763_L	0.3164	0.747	0.68	15
278	309	278_S	309_K	0.3162	0.746	0.679	31
415	420	415_S	420_S	0.3161	0.746	0.679	5
647	669	647_I	669_L	0.3159	0.745	0.677	22
308	312	308_E	312_N	0.3156	0.745	0.677	4
669	685	669_L	685_Y	0.3156	0.745	0.677	16
606	610	606_Q	610_I	0.3155	0.745	0.677	4
351	427	351_I	427_L	0.3155	0.744	0.676	76
463	491	463_H	491_L	0.3152	0.744	0.676	28
686	708	686_A	708_I	0.315	0.743	0.674	22
645	649	645_Q	649_I	0.315	0.743	0.674	4
427	446	427_L	446_A	0.3146	0.742	0.673	19
599	639	599_F	639_R	0.3146	0.742	0.673	40
215	219	215_R	219_K	0.3145	0.742	0.673	4
688	692	688_K	692_Y	0.3142	0.741	0.671	4
476	484	476_K	484_A	0.3139	0.741	0.671	8
469	484	469_L	484_A	0.3137	0.74	0.67	15
411	426	411_A	426_Y	0.3134	0.739	0.668	15
239	243	239_D	243_W	0.3127	0.738	0.667	4
504	508	504_Y	508_I	0.3123	0.737	0.665	4
237	260	237_I	260_M	0.312	0.736	0.664	23
374	378	374_K	378_Q	0.3113	0.735	0.662	4
214	243	214_L	243_W	0.3111	0.734	0.66	29
582	590	582_N	590_Y	0.3109	0.734	0.66	8
470	485	470_M	485_L	0.3108	0.733	0.659	15
526	529	526_N	529_K	0.3105	0.733	0.659	3
733	739	733_K	739_R	0.3102	0.732	0.657	6
373	388	373_A	388_I	0.3101	0.732	0.657	15
559	582	559_K	582_N	0.31	0.732	0.657	23
239	242	239_D	242_N	0.31	0.731	0.656	3
218	240	218_N	240_A	0.3098	0.731	0.656	22
265	270	265_I	270_R	0.3095	0.73	0.654	5
257	283	257_L	283_E	0.3095	0.73	0.654	26
339	344	339_L	344_V	0.3093	0.73	0.654	5
377	415	377_N	415_S	0.3091	0.729	0.653	38
681	685	681_T	685_Y	0.3088	0.729	0.653	4
238	241	238_D	241_K	0.3088	0.729	0.653	3
683	712	683_L	712_A	0.3088	0.729	0.653	29
347	351	347_A	351_I	0.3083	0.728	0.651	4
733	742	733_K	742_A	0.3083	0.728	0.651	9
748	752	748_L	752_R	0.3082	0.727	0.65	4
683	709	683_L	709_Y	0.3081	0.727	0.65	26
596	599	596_S	599_F	0.308	0.727	0.65	3
262	296	262_R	296_D	0.308	0.727	0.65	34
493	498	493_Y	498_F	0.3079	0.727	0.65	5
564	579	564_A	579_I	0.3077	0.726	0.648	15
377	385	377_N	385_S	0.3076	0.726	0.648	8
374	389	374_K	389_Y	0.3072	0.725	0.647	15
444	465	444_K	465_R	0.307	0.724	0.645	21
377	409	377_N	409_D	0.3066	0.724	0.645	32
667	670	667_D	670_L	0.3065	0.723	0.643	3
403	406	403_Y	406_T	0.3064	0.723	0.643	3
683	716	683_L	716_I	0.3061	0.722	0.642	33
273	300	273_V	300_Y	0.3058	0.722	0.642	27
319	356	319_F	356_K	0.3057	0.721	0.64	37
434	437	434_Y	437_G	0.3056	0.721	0.64	3
211	256	211_L	256_V	0.3056	0.721	0.64	45
265	300	265_I	300_Y	0.3054	0.721	0.64	35
296	299	296_D	299_D	0.3053	0.72	0.639	3
500	504	500_A	504_Y	0.3049	0.719	0.637	4
538	569	538_I	569_T	0.3044	0.718	0.635	31
751	759	751_E	759_E	0.304	0.717	0.634	8
635	639	635_L	639_R	0.3037	0.717	0.634	4
672	676	672_Y	676_H	0.3035	0.716	0.632	4
567	579	567_I	579_I	0.3033	0.716	0.632	12
384	388	384_I	388_I	0.3031	0.715	0.631	4
620	695	620_L	695_F	0.303	0.715	0.631	75
273	277	273_V	277_M	0.3021	0.713	0.627	4
307	341	307_K	341_N	0.3017	0.712	0.626	34
651	669	651_Q	669_L	0.3014	0.711	0.624	18
259	262	259_I	262_R	0.3007	0.71	0.623	3
730	746	730_L	746_Q	0.3006	0.709	0.621	16
412	427	412_L	427_L	0.3005	0.709	0.621	15
345	349	345_N	349_E	0.3004	0.709	0.621	4
714	745	714_T	745_I	0.3003	0.709	0.621	31
369	395	369_S	395_K	0.3	0.708	0.619	26
644	676	644_N	676_H	0.3	0.708	0.619	32
281	293	281_D	293_S	0.2999	0.708	0.619	12
610	649	610_I	649_I	0.2998	0.707	0.618	39
532	540	532_I	540_A	0.2994	0.707	0.618	8
680	716	680_T	716_I	0.2993	0.706	0.616	36
525	558	525_I	558_N	0.299	0.706	0.616	33
493	530	493_Y	530_N	0.2984	0.704	0.613	37
487	490	487_E	490_A	0.2983	0.704	0.613	3
503	648	503_A	648_K	0.2973	0.702	0.61	145
177	196	177_I	196_A	0.2971	0.701	0.608	19
189	193	189_V	193_A	0.297	0.701	0.608	4
577	580	577_D	580_D	0.2966	0.7	0.606	3
504	610	504_Y	610_I	0.2965	0.7	0.606	106
415	423	415_S	423_A	0.2964	0.699	0.605	8
415	493	415_S	493_Y	0.2964	0.699	0.605	78
485	511	485_L	511_K	0.296	0.699	0.605	26
186	216	186_Y	216_A	0.2959	0.698	0.603	30
210	242	210_I	242_N	0.2956	0.698	0.603	32
339	415	339_L	415_S	0.2954	0.697	0.601	76
505	509	505_K	509_E	0.2952	0.697	0.601	4
567	572	567_I	572_V	0.295	0.696	0.6	5
196	199	196_A	199_R	0.2949	0.696	0.6	3
744	747	744_Y	747_A	0.2945	0.695	0.598	3
427	505	427_L	505_K	0.2941	0.694	0.596	78
761	764	761_E	764_K	0.2937	0.693	0.595	3
670	689	670_L	689_A	0.2935	0.693	0.595	19
181	186	181_Y	186_Y	0.2935	0.693	0.595	5
390	422	390_E	422_D	0.2933	0.692	0.593	32
694	697	694_N	697_G	0.2933	0.692	0.593	3
176	180	176_R	180_E	0.2929	0.691	0.592	4
546	549	546_R	549_A	0.2928	0.691	0.592	3
214	236	214_L	236_M	0.2928	0.691	0.592	22
388	426	388_I	426_Y	0.2926	0.691	0.592	38
644	648	644_N	648_K	0.2924	0.69	0.59	4
451	461	451_F	461_F	0.2919	0.689	0.588	10
560	564	560_K	564_A	0.2919	0.689	0.588	4
238	242	238_D	242_N	0.2916	0.688	0.587	4
579	597	579_I	597_I	0.2914	0.688	0.587	18
349	352	349_E	352_N	0.2913	0.688	0.587	3
719	749	719_N	749_T	0.2913	0.687	0.585	30
561	564	561_Q	564_A	0.2911	0.687	0.585	3
559	585	559_K	585_E	0.2908	0.686	0.583	26
339	375	339_L	375_L	0.2899	0.684	0.58	36
483	487	483_K	487_E	0.2897	0.684	0.58	4
591	617	591_G	617_S	0.2895	0.683	0.578	26
243	256	243_W	256_V	0.2893	0.683	0.578	13
428	461	428_D	461_F	0.2891	0.682	0.576	33
572	576	572_V	576_L	0.2891	0.682	0.576	4
574	578	574_Q	578_Y	0.289	0.682	0.576	4
583	591	583_Y	591_G	0.2887	0.681	0.575	8
428	506	428_D	506_D	0.2886	0.681	0.575	78
387	390	387_S	390_E	0.2884	0.681	0.575	3
727	730	727_T	730_L	0.2881	0.68	0.573	3
498	530	498_F	530_N	0.2874	0.678	0.57	32
176	192	176_R	192_D	0.2865	0.676	0.566	16
426	429	426_Y	429_L	0.2862	0.675	0.565	3
567	597	567_I	597_I	0.2859	0.675	0.565	30
508	523	508_I	523_A	0.2858	0.675	0.565	15
578	581	578_Y	581_K	0.2856	0.674	0.563	3
589	593	589_F	593_Q	0.2855	0.674	0.563	4
312	315	312_N	315_E	0.2854	0.673	0.561	3
461	465	461_F	465_R	0.2853	0.673	0.561	4
467	500	467_T	500_A	0.2852	0.673	0.561	33
638	646	638_L	646_A	0.2848	0.672	0.56	8
720	723	720_E	723_L	0.2844	0.671	0.558	3
393	410	393_F	410_L	0.2844	0.671	0.558	17
374	412	374_K	412_L	0.2844	0.671	0.558	38
635	668	635_L	668_A	0.2843	0.671	0.558	33
345	421	345_N	421_S	0.2843	0.671	0.558	76
541	562	541_A	562_M	0.2839	0.67	0.556	21
462	466	462_L	466_Y	0.2839	0.67	0.556	4
631	653	631_Y	653_L	0.2837	0.669	0.555	22
351	375	351_I	375_L	0.2835	0.669	0.555	24
630	706	630_Y	706_E	0.2832	0.668	0.553	76
386	419	386_A	419_R	0.2832	0.668	0.553	33
203	209	203_S	209_F	0.2831	0.668	0.553	6
294	320	294_K	320_N	0.2828	0.667	0.551	26
339	347	339_L	347_A	0.2824	0.666	0.549	8
687	709	687_P	709_Y	0.2823	0.666	0.549	22
713	716	713_L	716_I	0.2822	0.666	0.549	3
643	647	643_Y	647_I	0.282	0.665	0.548	4
448	462	448_D	462_L	0.2818	0.665	0.548	14
241	272	241_K	272_D	0.2814	0.664	0.546	31
331	357	331_A	357_A	0.2813	0.664	0.546	26
493	567	493_Y	567_I	0.2813	0.664	0.546	74
524	591	524_A	591_G	0.281	0.663	0.544	67
178	182	178_K	182_D	0.2808	0.663	0.544	4
490	505	490_A	505_K	0.2805	0.662	0.543	15
727	750	727_T	750_Y	0.28	0.661	0.541	23
437	440	437_G	440_L	0.2799	0.661	0.541	3
351	505	351_I	505_K	0.279	0.658	0.536	154
572	575	572_V	575_A	0.279	0.658	0.536	3
270	274	270_R	274_E	0.2789	0.658	0.536	4
635	638	635_L	638_L	0.2788	0.658	0.536	3
521	547	521_E	547_F	0.2787	0.658	0.536	26
197	210	197_I	210_I	0.2783	0.657	0.534	13
725	729	725_V	729_L	0.2783	0.657	0.534	4
680	683	680_T	683_L	0.2783	0.657	0.534	3
612	651	612_K	651_Q	0.278	0.656	0.532	39
649	653	649_I	653_L	0.278	0.656	0.532	4
356	394	356_K	394_A	0.278	0.656	0.532	38
583	594	583_Y	594_K	0.2775	0.655	0.531	11
355	369	355_L	369_S	0.2765	0.652	0.526	14
509	524	509_E	524_A	0.2764	0.652	0.526	15
348	381	348_I	381_Q	0.2762	0.652	0.526	33
178	193	178_K	193_A	0.2761	0.651	0.524	15
274	306	274_E	306_E	0.276	0.651	0.524	32
604	639	604_Y	639_R	0.2754	0.65	0.522	35
336	351	336_K	351_I	0.2749	0.649	0.52	15
407	524	407_L	524_A	0.2746	0.648	0.519	117
714	722	714_T	722_S	0.2746	0.648	0.519	8
506	539	506_D	539_N	0.2745	0.648	0.519	33
270	304	270_R	304_L	0.2743	0.647	0.517	34
396	403	396_M	403_Y	0.2743	0.647	0.517	7
390	506	390_E	506_D	0.2743	0.647	0.517	116
237	264	237_I	264_Y	0.2734	0.645	0.514	27
705	708	705_L	708_I	0.2726	0.643	0.51	3
174	178	174_Y	178_K	0.2726	0.643	0.51	4
389	427	389_Y	427_L	0.2725	0.643	0.51	38
586	590	586_D	590_Y	0.2725	0.643	0.51	4
336	339	336_K	339_L	0.2724	0.643	0.51	3
743	769	743_L	769_I	0.272	0.642	0.508	26
605	608	605_P	608_I	0.272	0.642	0.508	3
470	484	470_M	484_A	0.272	0.642	0.508	14
315	338	315_E	338_L	0.2719	0.642	0.508	23
265	273	265_I	273_V	0.2717	0.641	0.507	8
272	276	272_D	276_T	0.2717	0.641	0.507	4
683	713	683_L	713_L	0.2712	0.64	0.505	30
404	408	404_E	408_K	0.2712	0.64	0.505	4
408	486	408_K	486_D	0.2712	0.64	0.505	78
451	465	451_F	465_R	0.271	0.64	0.505	14
403	407	403_Y	407_L	0.271	0.639	0.503	4
670	673	670_L	673_A	0.2709	0.639	0.503	3
540	544	540_A	544_F	0.2707	0.639	0.503	4
593	596	593_Q	596_S	0.2705	0.638	0.502	3
412	446	412_L	446_A	0.2701	0.637	0.5	34
190	217	190_V	217_Q	0.2698	0.637	0.5	27
685	689	685_Y	689_A	0.269	0.635	0.496	4
382	420	382_F	420_S	0.2689	0.635	0.496	38
420	424	420_S	424_K	0.2683	0.633	0.493	4
424	502	424_K	502_L	0.2682	0.633	0.493	78
539	543	539_N	543_I	0.2681	0.633	0.493	4
361	621	361_Y	621_K	0.2678	0.632	0.491	260
687	721	687_P	721_E	0.2677	0.632	0.491	34
356	510	356_K	510_S	0.2677	0.632	0.491	154
307	344	307_K	344_V	0.2672	0.63	0.488	37
277	297	277_M	297_Y	0.2663	0.628	0.484	20
638	714	638_L	714_T	0.2663	0.628	0.484	76
671	708	671_S	708_I	0.266	0.628	0.484	37
583	590	583_Y	590_Y	0.2655	0.627	0.483	7
532	599	532_I	599_F	0.2655	0.626	0.481	67
760	763	760_K	763_L	0.2649	0.625	0.479	3
383	386	383_D	386_A	0.2649	0.625	0.479	3
344	348	344_V	348_I	0.2644	0.624	0.478	4
342	418	342_E	418_N	0.264	0.623	0.476	76
397	619	397_S	619_I	0.2639	0.623	0.476	222
352	428	352_N	428_D	0.2637	0.622	0.474	76
484	590	484_A	590_Y	0.2636	0.622	0.474	106
736	739	736_D	739_R	0.2633	0.621	0.472	3
630	656	630_Y	656_F	0.2633	0.621	0.472	26
380	418	380_G	418_N	0.2632	0.621	0.472	38
416	494	416_H	494_K	0.2632	0.621	0.472	78
744	763	744_Y	763_L	0.2632	0.621	0.472	19
308	345	308_E	345_N	0.263	0.621	0.472	37
567	600	567_I	600_D	0.263	0.621	0.472	33
545	574	545_M	574_Q	0.2629	0.62	0.471	29
719	752	719_N	752_R	0.2623	0.619	0.469	33
302	340	302_Y	340_S	0.2623	0.619	0.469	38
241	244	241_K	244_T	0.262	0.618	0.467	3
407	433	407_L	433_D	0.2618	0.618	0.467	26
503	609	503_A	609_K	0.2617	0.618	0.467	106
530	534	530_N	534_A	0.2617	0.617	0.466	4
532	537	532_I	537_C	0.2616	0.617	0.466	5
173	192	173_T	192_D	0.2616	0.617	0.466	19
544	611	544_F	611_S	0.2612	0.616	0.464	67
218	233	218_N	233_L	0.2604	0.614	0.46	15
350	388	350_Y	388_I	0.2604	0.614	0.46	38
302	310	302_Y	310_A	0.2601	0.614	0.46	8
459	491	459_A	491_L	0.26	0.614	0.46	32
508	511	508_I	511_K	0.2596	0.613	0.459	3
647	673	647_I	673_A	0.2595	0.612	0.457	26
726	742	726_L	742_A	0.2594	0.612	0.457	16
610	614	610_I	614_I	0.2589	0.611	0.455	4
538	541	538_I	541_A	0.258	0.609	0.452	3
253	256	253_F	256_V	0.2579	0.608	0.45	3
684	688	684_T	688_K	0.2577	0.608	0.45	4
491	495	491_L	495_E	0.2576	0.608	0.45	4
277	293	277_M	293_S	0.2576	0.608	0.45	16
312	425	312_N	425_K	0.2574	0.607	0.449	113
387	425	387_S	425_K	0.2572	0.607	0.449	38
720	724	720_E	724_A	0.2571	0.607	0.449	4
498	533	498_F	533_K	0.2571	0.607	0.449	35
537	541	537_C	541_A	0.257	0.606	0.447	4
181	216	181_Y	216_A	0.257	0.606	0.447	35
505	611	505_K	611_S	0.256	0.604	0.443	106
740	747	740_A	747_A	0.2559	0.604	0.443	7
299	302	299_D	302_Y	0.2558	0.604	0.443	3
459	462	459_A	462_L	0.2557	0.603	0.442	3
236	243	236_M	243_W	0.2557	0.603	0.442	7
626	630	626_N	630_Y	0.2553	0.602	0.44	4
464	467	464_Q	467_T	0.2552	0.602	0.44	3
575	597	575_A	597_I	0.2551	0.602	0.44	22
394	432	394_A	432_D	0.2551	0.602	0.44	38
611	615	611_S	615_A	0.2551	0.602	0.44	4
612	615	612_K	615_A	0.255	0.602	0.44	3
243	246	243_W	246_T	0.2549	0.602	0.44	3
644	647	644_N	647_I	0.2548	0.601	0.438	3
450	454	450_V	454_L	0.2546	0.601	0.438	4
377	493	377_N	493_Y	0.2541	0.6	0.437	116
181	212	181_Y	212_Y	0.2539	0.599	0.435	31
255	259	255_E	259_I	0.2538	0.599	0.435	4
349	425	349_E	425_K	0.2535	0.598	0.433	76
591	595	591_G	595_A	0.2534	0.598	0.433	4
345	499	345_N	499_S	0.2534	0.598	0.433	154
491	636	491_L	636_S	0.2533	0.598	0.433	145
679	712	679_Q	712_A	0.2529	0.597	0.432	33
189	216	189_V	216_A	0.2525	0.596	0.43	27
493	501	493_Y	501_I	0.2524	0.596	0.43	8
432	510	432_D	510_S	0.2524	0.596	0.43	78
496	570	496_G	570_S	0.2523	0.595	0.428	74
359	435	359_P	435_L	0.2522	0.595	0.428	76
421	538	421_S	538_I	0.2519	0.594	0.427	117
602	641	602_K	641_N	0.2519	0.594	0.427	39
388	504	388_I	504_Y	0.2516	0.594	0.427	116
598	601	598_L	601_N	0.2512	0.593	0.425	3
214	239	214_L	239_D	0.2507	0.592	0.423	25
564	567	564_A	567_I	0.2505	0.591	0.422	3
535	602	535_D	602_K	0.2502	0.59	0.42	67
307	311	307_K	311_V	0.2498	0.59	0.42	4
