i	j	i_id	j_id	r_sco	s_sco	prob	distance
514	517	514_N	517_L	1.6009	4.716	1	3
296	299	296_F	299_K	1.5669	4.616	1	3
359	362	359_N	362_D	1.52	4.478	1	3
759	762	759_N	762_S	1.5037	4.43	1	3
480	483	480_K	483_L	1.4939	4.401	1	3
192	195	192_K	195_E	1.4934	4.4	1	3
325	328	325_E	328_K	1.4924	4.397	1	3
613	616	613_L	616_Q	1.4764	4.35	1	3
263	266	263_Y	266_E	1.4599	4.301	1	3
724	727	724_Q	727_E	1.4583	4.296	1	3
448	451	448_D	451_D	1.3896	4.094	1	3
160	163	160_E	163_Q	1.2562	3.701	1	3
226	229	226_D	229_K	1.2369	3.644	1	3
549	552	549_D	552_K	1.231	3.627	1	3
689	692	689_L	692_L	1.2237	3.605	1	3
647	650	647_N	650_E	1.2164	3.584	1	3
793	796	793_N	796_A	1.0643	3.136	1	3
582	585	582_N	585_S	0.8747	2.577	1	3
751	767	751_A	767_L	0.7606	2.241	1	16
472	488	472_I	488_F	0.7429	2.189	1	16
255	271	255_S	271_L	0.7272	2.142	1	16
351	367	351_T	367_L	0.7255	2.138	1	16
506	522	506_A	522_F	0.7191	2.119	1	16
505	521	505_L	521_H	0.707	2.083	1	16
489	505	489_Q	505_L	0.7068	2.083	1	16
440	456	440_A	456_L	0.6958	2.05	1	16
184	200	184_G	200_F	0.6904	2.034	1	16
317	333	317_G	333_L	0.6736	1.985	1	16
272	287	272_Q	287_S	0.6695	1.972	1	15
268	272	268_L	272_Q	0.6634	1.954	1	4
502	521	502_H	521_H	0.662	1.95	1	19
328	331	328_K	331_V	0.6367	1.876	1	3
218	234	218_A	234_I	0.6364	1.875	1	16
509	517	509_Y	517_L	0.6323	1.863	1	8
288	304	288_A	304_L	0.632	1.862	1	16
334	350	334_S	350_L	0.6318	1.861	1	16
396	399	396_N	399_V	0.6277	1.849	1	3
716	732	716_A	732_Y	0.6247	1.84	1	16
457	471	457_N	471_N	0.6102	1.798	1	14
750	766	750_A	766_L	0.6082	1.792	1	16
618	622	618_D	622_A	0.6059	1.785	1	4
180	199	180_N	199_S	0.6031	1.777	1	19
183	187	183_L	187_Q	0.6029	1.776	1	4
605	621	605_A	621_I	0.5991	1.765	1	16
291	299	291_Y	299_K	0.5961	1.756	1	8
287	291	287_S	291_Y	0.5942	1.751	1	4
483	486	483_L	486_Q	0.5932	1.748	1	3
330	334	330_K	334_S	0.5924	1.745	1	4
350	354	350_L	354_D	0.5921	1.745	1	4
316	320	316_L	320_Y	0.5878	1.732	0.999	4
152	168	152_A	168_Y	0.5875	1.731	0.999	16
485	489	485_N	489_Q	0.5874	1.73	0.999	4
719	724	719_D	724_Q	0.5873	1.73	0.999	5
183	199	183_L	199_S	0.5822	1.715	0.999	16
347	366	347_L	366_R	0.582	1.715	0.999	19
195	198	195_E	198_E	0.5768	1.699	0.999	3
187	192	187_Q	192_K	0.5752	1.694	0.999	5
604	620	604_E	620_K	0.5719	1.685	0.999	16
169	183	169_E	183_L	0.5701	1.68	0.999	14
254	258	254_L	258_N	0.5661	1.668	0.999	4
475	483	475_Y	483_L	0.5656	1.666	0.999	8
754	762	754_A	762_S	0.565	1.665	0.999	8
729	733	729_Y	733_N	0.563	1.659	0.999	4
505	509	505_L	509_Y	0.5627	1.658	0.999	4
639	655	639_F	655_A	0.5625	1.657	0.999	16
362	365	362_D	365_A	0.5596	1.649	0.999	3
217	221	217_A	221_A	0.5575	1.643	0.999	4
712	731	712_L	731_L	0.557	1.641	0.999	19
623	626	623_K	626_S	0.5561	1.638	0.999	3
764	768	764_I	768_Q	0.5561	1.638	0.999	4
299	302	299_K	302_Q	0.5537	1.631	0.999	3
284	303	284_K	303_Q	0.5515	1.625	0.999	19
187	195	187_Q	195_E	0.5465	1.61	0.999	8
468	487	468_K	487_E	0.5451	1.606	0.999	19
471	487	471_N	487_E	0.5433	1.601	0.999	16
754	759	754_A	759_N	0.543	1.6	0.999	5
316	332	316_L	332_A	0.5421	1.597	0.999	16
165	169	165_L	169_E	0.542	1.597	0.999	4
151	155	151_K	155_L	0.5411	1.594	0.999	4
608	616	608_A	616_Q	0.5385	1.587	0.999	8
715	731	715_L	731_L	0.5341	1.574	0.998	16
719	727	719_D	727_E	0.5321	1.568	0.998	8
734	737	734_S	737_D	0.5312	1.565	0.998	3
221	226	221_A	226_D	0.5304	1.563	0.998	5
287	303	287_S	303_Q	0.53	1.561	0.998	16
271	286	271_L	286_L	0.5296	1.56	0.998	15
517	520	517_L	520_K	0.5286	1.557	0.998	3
475	487	475_Y	487_E	0.5279	1.555	0.998	12
451	454	451_D	454_V	0.5257	1.549	0.998	3
519	523	519_Y	523_S	0.5226	1.54	0.998	4
168	182	168_Y	182_N	0.522	1.538	0.998	14
197	201	197_F	201_K	0.5211	1.535	0.998	4
221	229	221_A	229_K	0.5209	1.535	0.998	8
301	305	301_I	305_N	0.5205	1.534	0.998	4
443	451	443_T	451_D	0.5191	1.529	0.998	8
509	514	509_Y	514_N	0.5189	1.529	0.998	5
727	730	727_E	730_A	0.5181	1.527	0.998	3
762	765	762_S	765_A	0.5176	1.525	0.998	3
747	766	747_L	766_L	0.5168	1.523	0.998	19
694	698	694_R	698_K	0.5164	1.521	0.998	4
436	455	436_Y	455_Y	0.516	1.52	0.998	19
201	217	201_K	217_A	0.5142	1.515	0.998	16
320	325	320_Y	325_E	0.5142	1.515	0.998	5
350	366	350_L	366_R	0.5136	1.513	0.998	16
616	619	616_Q	619_V	0.5112	1.506	0.997	3
254	270	254_L	270_M	0.5111	1.506	0.997	16
552	555	552_K	555_N	0.5107	1.505	0.997	3
439	455	439_K	455_Y	0.5104	1.504	0.997	16
354	366	354_D	366_R	0.5095	1.501	0.997	12
471	475	471_N	475_Y	0.5092	1.5	0.997	4
364	368	364_L	368_Q	0.5068	1.493	0.997	4
266	269	266_E	269_Q	0.5051	1.488	0.997	3
453	457	453_G	457_N	0.5044	1.486	0.997	4
291	296	291_Y	296_F	0.5039	1.485	0.997	5
229	232	229_K	232_Y	0.5035	1.483	0.997	3
769	772	769_L	772_L	0.497	1.464	0.997	3
291	303	291_Y	303_Q	0.4964	1.462	0.997	12
330	353	330_K	353_V	0.4939	1.455	0.996	23
235	254	235_D	254_L	0.4931	1.453	0.996	19
231	235	231_R	235_D	0.4895	1.442	0.996	4
469	501	469_I	501_L	0.4894	1.442	0.996	32
715	719	715_L	719_D	0.4893	1.442	0.996	4
251	270	251_D	270_M	0.4882	1.438	0.996	19
488	504	488_F	504_N	0.4866	1.434	0.996	16
354	362	354_D	362_D	0.4857	1.431	0.996	8
540	544	540_M	544_K	0.4847	1.428	0.996	4
187	199	187_Q	199_S	0.4846	1.428	0.996	12
785	801	785_G	801_Y	0.4833	1.424	0.996	16
313	332	313_S	332_A	0.4793	1.412	0.995	19
305	316	305_N	316_L	0.4791	1.411	0.995	11
443	448	443_T	448_D	0.4782	1.409	0.995	5
469	504	469_I	504_N	0.4777	1.408	0.995	35
650	653	650_E	653_Q	0.4774	1.406	0.995	3
217	233	217_A	233_Y	0.4765	1.404	0.995	16
733	750	733_N	750_A	0.4759	1.402	0.995	17
258	270	258_N	270_M	0.4751	1.4	0.995	12
285	312	285_Y	312_S	0.4744	1.398	0.995	27
475	480	475_Y	480_K	0.4742	1.397	0.995	5
729	753	729_Y	753_A	0.4729	1.393	0.994	24
155	163	155_L	163_Q	0.471	1.388	0.994	8
554	558	554_Y	558_L	0.4706	1.387	0.994	4
320	328	320_Y	328_K	0.4703	1.386	0.994	8
638	642	638_Y	642_L	0.4701	1.385	0.994	4
155	160	155_L	160_E	0.4697	1.384	0.994	5
681	697	681_V	697_I	0.4675	1.377	0.994	16
258	263	258_N	263_Y	0.4656	1.372	0.994	5
354	359	354_D	359_N	0.4644	1.368	0.993	5
258	266	258_N	266_E	0.4632	1.365	0.993	8
456	470	456_L	470_A	0.4615	1.36	0.993	14
698	715	698_K	715_L	0.4607	1.357	0.993	17
485	508	485_N	508_T	0.4606	1.357	0.993	23
503	535	503_Y	535_A	0.4597	1.354	0.993	32
221	233	221_A	233_Y	0.4568	1.346	0.992	12
351	370	351_T	370_S	0.4567	1.346	0.992	19
509	521	509_Y	521_H	0.4564	1.345	0.992	12
750	754	750_A	754_A	0.4547	1.34	0.992	4
197	217	197_F	217_A	0.454	1.338	0.992	20
170	173	170_Q	173_V	0.4525	1.333	0.992	3
148	167	148_M	167_V	0.4521	1.332	0.992	19
234	253	234_I	253_Y	0.4516	1.33	0.991	19
541	557	541_F	557_I	0.4491	1.323	0.991	16
485	505	485_N	505_L	0.4448	1.31	0.99	20
524	527	524_S	527_H	0.4442	1.309	0.99	3
200	216	200_F	216_N	0.4441	1.308	0.99	16
716	735	716_A	735_L	0.4429	1.305	0.99	19
544	552	544_K	552_K	0.4422	1.303	0.99	8
439	443	439_K	443_T	0.442	1.302	0.99	4
485	509	485_N	509_Y	0.4407	1.298	0.989	24
788	796	788_Y	796_A	0.4358	1.284	0.988	8
621	637	621_I	637_L	0.4353	1.282	0.988	16
729	750	729_Y	750_A	0.4341	1.279	0.988	21
197	220	197_F	220_C	0.4327	1.275	0.988	23
330	350	330_K	350_L	0.4323	1.274	0.988	20
335	338	335_T	338_K	0.4318	1.272	0.987	3
151	167	151_K	167_V	0.4309	1.27	0.987	16
268	287	268_L	287_S	0.43	1.267	0.987	19
252	283	252_Y	283_A	0.43	1.267	0.987	31
202	205	202_K	205_A	0.4288	1.263	0.987	3
642	647	642_L	647_N	0.428	1.261	0.986	5
163	166	163_Q	166_K	0.4253	1.253	0.986	3
197	224	197_F	224_L	0.4247	1.251	0.985	27
769	773	769_L	773_T	0.4237	1.248	0.985	4
214	233	214_A	233_Y	0.4235	1.248	0.985	19
181	213	181_Y	213_A	0.423	1.246	0.985	32
211	237	211_S	237_A	0.4227	1.245	0.985	26
330	357	330_K	357_T	0.4224	1.245	0.985	27
680	684	680_Y	684_M	0.4208	1.24	0.984	4
732	749	732_Y	749_L	0.4202	1.238	0.984	17
207	210	207_G	210_Q	0.4179	1.231	0.983	3
288	307	288_A	307_Q	0.4167	1.228	0.983	19
506	525	506_A	525_S	0.4166	1.227	0.983	19
255	274	255_S	274_T	0.4145	1.221	0.982	19
770	780	770_S	780_S	0.4142	1.22	0.982	10
468	490	468_K	490_K	0.4133	1.218	0.982	22
490	493	490_K	493_K	0.4131	1.217	0.982	3
184	203	184_G	203_A	0.4127	1.216	0.982	19
327	357	327_A	357_T	0.4113	1.212	0.981	30
764	784	764_I	784_L	0.4108	1.21	0.981	20
788	793	788_Y	793_N	0.41	1.208	0.981	5
784	788	784_L	788_Y	0.41	1.208	0.981	4
298	323	298_S	323_I	0.4091	1.205	0.98	25
165	183	165_L	183_L	0.4077	1.201	0.98	18
171	179	171_V	179_S	0.4068	1.199	0.979	8
781	800	781_K	800_Q	0.4068	1.198	0.979	19
265	294	265_P	294_M	0.406	1.196	0.979	29
458	461	458_T	461_A	0.4048	1.193	0.978	3
692	695	692_L	695_Q	0.4048	1.193	0.978	3
314	346	314_L	346_S	0.4036	1.189	0.978	32
768	772	768_Q	772_L	0.4029	1.187	0.978	4
544	549	544_K	549_D	0.4029	1.187	0.978	5
652	656	652_A	656_Q	0.4027	1.186	0.977	4
440	459	440_A	459_S	0.4022	1.185	0.977	19
491	501	491_L	501_L	0.4018	1.184	0.977	10
236	239	236_L	239_V	0.4017	1.183	0.977	3
317	336	317_G	336_A	0.4007	1.181	0.977	19
343	346	343_F	346_S	0.4	1.178	0.976	3
541	553	541_F	553_L	0.3987	1.174	0.976	12
177	203	177_S	203_A	0.3982	1.173	0.975	26
218	230	218_A	230_F	0.3976	1.172	0.975	12
333	349	333_L	349_A	0.3963	1.167	0.974	16
796	799	796_A	799_S	0.396	1.167	0.974	3
301	320	301_I	320_Y	0.3946	1.163	0.974	19
330	354	330_K	354_D	0.3937	1.16	0.973	24
162	190	162_E	190_E	0.3927	1.157	0.973	28
726	757	726_E	757_A	0.3926	1.157	0.973	31
369	372	369_N	372_D	0.3925	1.156	0.972	3
774	777	774_D	777_N	0.3925	1.156	0.972	3
145	171	145_I	171_V	0.392	1.155	0.972	26
608	613	608_A	613_L	0.3916	1.154	0.972	5
709	735	709_E	735_L	0.391	1.152	0.972	26
754	766	754_A	766_L	0.3903	1.15	0.971	12
165	186	165_L	186_S	0.3902	1.15	0.971	21
188	200	188_M	200_F	0.3893	1.147	0.971	12
735	746	735_L	746_T	0.3891	1.146	0.971	11
713	749	713_Q	749_L	0.387	1.14	0.969	36
453	471	453_G	471_N	0.3869	1.14	0.969	18
194	224	194_Q	224_L	0.3868	1.14	0.969	30
642	650	642_L	650_E	0.3864	1.138	0.969	8
320	332	320_Y	332_A	0.386	1.137	0.969	12
347	369	347_L	369_N	0.3855	1.136	0.969	22
734	738	734_S	738_D	0.3854	1.135	0.968	4
730	734	730_A	734_S	0.3852	1.135	0.968	4
716	731	716_A	731_L	0.3852	1.135	0.968	15
729	757	729_Y	757_A	0.3846	1.133	0.968	28
152	171	152_A	171_V	0.3842	1.132	0.968	19
231	254	231_R	254_L	0.3839	1.131	0.967	23
453	474	453_G	474_N	0.383	1.128	0.967	21
684	689	684_M	689_L	0.3819	1.125	0.966	5
368	372	368_Q	372_D	0.3818	1.125	0.966	4
784	800	784_L	800_Q	0.3805	1.121	0.965	16
274	283	274_T	283_A	0.3794	1.118	0.965	9
304	315	304_L	315_S	0.3791	1.117	0.964	11
482	512	482_R	512_M	0.3789	1.116	0.964	30
697	714	697_I	714_T	0.3789	1.116	0.964	17
472	484	472_I	484_A	0.3787	1.116	0.964	12
301	319	301_I	319_L	0.3777	1.113	0.963	18
334	338	334_S	338_K	0.3777	1.113	0.963	4
218	237	218_A	237_A	0.3774	1.112	0.963	19
443	455	443_T	455_Y	0.3773	1.112	0.963	12
281	307	281_D	307_Q	0.3761	1.108	0.962	26
767	783	767_L	783_A	0.3756	1.107	0.962	16
236	240	236_L	240_Y	0.3751	1.105	0.961	4
733	762	733_N	762_S	0.3751	1.105	0.961	29
268	291	268_L	291_Y	0.3734	1.1	0.96	23
733	737	733_N	737_D	0.3734	1.1	0.96	4
489	493	489_Q	493_K	0.3732	1.1	0.96	4
156	168	156_Y	168_Y	0.373	1.099	0.96	12
523	540	523_S	540_M	0.3714	1.094	0.958	17
604	608	604_E	608_A	0.3709	1.093	0.958	4
559	563	559_D	563_A	0.3695	1.089	0.957	4
622	626	622_A	626_S	0.3678	1.084	0.956	4
317	329	317_G	329_A	0.3675	1.083	0.955	12
155	167	155_L	167_V	0.3661	1.079	0.954	12
473	504	473_I	504_N	0.3656	1.077	0.954	31
344	370	344_N	370_S	0.3654	1.077	0.954	26
751	770	751_A	770_S	0.365	1.075	0.953	19
622	638	622_A	638_Y	0.3644	1.074	0.953	16
351	363	351_T	363_M	0.3632	1.07	0.951	12
165	190	165_L	190_E	0.3631	1.07	0.951	25
628	631	628_L	631_D	0.3629	1.069	0.951	3
729	754	729_Y	754_A	0.3628	1.069	0.951	25
785	800	785_G	800_Q	0.3616	1.065	0.95	15
785	804	785_G	804_L	0.3611	1.064	0.949	19
481	508	481_L	508_T	0.3607	1.063	0.949	27
485	512	485_N	512_M	0.3602	1.061	0.948	27
768	784	768_Q	784_L	0.3601	1.061	0.948	16
235	239	235_D	239_V	0.3598	1.06	0.948	4
639	658	639_F	658_H	0.3597	1.06	0.948	19
336	346	336_A	346_S	0.3597	1.06	0.948	10
624	634	624_L	634_A	0.3595	1.059	0.948	10
401	405	401_Q	405_S	0.3595	1.059	0.948	4
495	498	495_Y	498_H	0.3585	1.056	0.947	3
694	715	694_R	715_L	0.3583	1.056	0.947	21
314	349	314_L	349_A	0.3582	1.055	0.946	35
453	475	453_G	475_Y	0.3579	1.055	0.946	22
798	802	798_I	802_K	0.3579	1.054	0.946	4
765	769	765_A	769_L	0.3577	1.054	0.946	4
523	527	523_S	527_H	0.3576	1.054	0.946	4
284	307	284_K	307_Q	0.3574	1.053	0.946	23
472	491	472_I	491_L	0.3566	1.051	0.945	19
524	528	524_S	528_L	0.3566	1.051	0.945	4
203	213	203_A	213_A	0.3565	1.05	0.945	10
623	627	623_K	627_E	0.356	1.049	0.944	4
755	767	755_I	767_L	0.3558	1.048	0.944	12
264	290	264_Y	290_I	0.3551	1.046	0.943	26
436	458	436_Y	458_T	0.3542	1.043	0.942	22
506	521	506_A	521_H	0.3541	1.043	0.942	15
318	322	318_L	322_R	0.3536	1.042	0.942	4
502	524	502_H	524_S	0.3534	1.041	0.941	22
502	525	502_H	525_S	0.3534	1.041	0.941	23
181	185	181_Y	185_V	0.3527	1.039	0.94	4
751	766	751_A	766_L	0.3523	1.038	0.94	15
170	174	170_Q	174_Y	0.3521	1.037	0.94	4
186	190	186_S	190_E	0.3517	1.036	0.939	4
476	488	476_A	488_F	0.3501	1.032	0.938	12
472	487	472_I	487_E	0.3496	1.03	0.937	15
713	746	713_Q	746_T	0.3494	1.029	0.937	33
642	654	642_L	654_N	0.3492	1.029	0.937	12
301	323	301_I	323_I	0.3469	1.022	0.934	22
506	518	506_A	518_A	0.3463	1.02	0.933	12
457	461	457_N	461_A	0.346	1.019	0.932	4
347	370	347_L	370_S	0.3453	1.017	0.931	23
149	179	149_I	179_S	0.3446	1.015	0.931	30
788	800	788_Y	800_Q	0.3445	1.015	0.931	12
369	373	369_N	373_N	0.3445	1.015	0.931	4
255	270	255_S	270_M	0.3437	1.013	0.93	15
352	356	352_L	356_K	0.3433	1.012	0.929	4
329	333	329_A	333_L	0.3424	1.009	0.928	4
712	734	712_L	734_S	0.3418	1.007	0.927	22
771	780	771_K	780_S	0.3418	1.007	0.927	9
326	353	326_Y	353_V	0.3417	1.007	0.927	27
268	294	268_L	294_M	0.3415	1.006	0.926	26
486	490	486_Q	490_K	0.3414	1.006	0.926	4
148	171	148_M	171_V	0.3413	1.005	0.926	23
153	168	153_N	168_Y	0.3409	1.004	0.926	15
618	641	618_D	641_S	0.3408	1.004	0.926	23
166	170	166_K	170_Q	0.3401	1.002	0.925	4
499	525	499_S	525_S	0.3392	0.999	0.923	26
585	588	585_S	588_P	0.3384	0.997	0.922	3
520	524	520_K	524_S	0.3374	0.994	0.921	4
655	679	655_A	679_F	0.3373	0.994	0.921	24
638	654	638_Y	654_N	0.337	0.993	0.92	16
321	333	321_A	333_L	0.3369	0.993	0.92	12
766	769	766_L	769_L	0.3363	0.991	0.919	3
317	332	317_G	332_A	0.3352	0.987	0.917	15
540	556	540_M	556_E	0.3349	0.987	0.917	16
355	367	355_I	367_L	0.3348	0.986	0.917	12
440	452	440_A	452_A	0.3345	0.986	0.917	12
801	805	801_Y	805_P	0.3339	0.984	0.915	4
736	747	736_I	747_L	0.3339	0.984	0.915	11
337	346	337_M	346_S	0.3335	0.982	0.914	9
284	306	284_K	306_S	0.3334	0.982	0.914	22
544	556	544_K	556_E	0.3333	0.982	0.914	12
719	731	719_D	731_L	0.3332	0.982	0.914	12
230	234	230_F	234_I	0.332	0.978	0.912	4
289	293	289_K	293_K	0.3311	0.976	0.911	4
169	173	169_E	173_V	0.3311	0.975	0.911	4
503	539	503_Y	539_A	0.3302	0.973	0.909	36
730	733	730_A	733_N	0.3296	0.971	0.908	3
789	801	789_Q	801_Y	0.3294	0.971	0.908	12
214	236	214_A	236_L	0.3293	0.97	0.908	22
214	237	214_A	237_A	0.3292	0.97	0.908	23
694	718	694_R	718_L	0.3279	0.966	0.905	24
215	250	215_I	250_Y	0.3278	0.966	0.905	35
259	290	259_Y	290_I	0.3275	0.965	0.905	31
695	699	695_Q	699_E	0.3272	0.964	0.904	4
335	339	335_T	339_I	0.3271	0.964	0.904	4
202	206	202_K	206_N	0.3271	0.964	0.904	4
559	562	559_D	562_A	0.3269	0.963	0.904	3
441	470	441_N	470_A	0.3266	0.962	0.903	29
164	168	164_A	168_Y	0.3256	0.959	0.901	4
301	316	301_I	316_L	0.3251	0.958	0.901	15
684	692	684_M	692_L	0.3244	0.956	0.899	8
302	306	302_Q	306_S	0.3243	0.955	0.899	4
522	539	522_F	539_A	0.3241	0.955	0.899	17
454	458	454_V	458_T	0.3234	0.953	0.897	4
519	540	519_Y	540_M	0.323	0.952	0.897	21
366	369	366_R	369_N	0.3225	0.95	0.896	3
618	638	618_D	638_Y	0.3222	0.949	0.895	20
525	528	525_S	528_L	0.3221	0.949	0.895	3
198	202	198_E	202_K	0.3217	0.948	0.894	4
492	501	492_I	501_L	0.3216	0.948	0.894	9
763	767	763_A	767_L	0.3216	0.947	0.894	4
319	323	319_L	323_I	0.3212	0.946	0.893	4
272	299	272_Q	299_K	0.3209	0.945	0.892	27
318	349	318_L	349_A	0.3209	0.945	0.892	31
450	478	450_A	478_N	0.3208	0.945	0.892	28
463	466	463_S	466_N	0.3199	0.942	0.89	3
608	620	608_A	620_K	0.3198	0.942	0.89	12
482	486	482_R	486_Q	0.3192	0.941	0.89	4
491	494	491_L	494_D	0.3186	0.939	0.888	3
736	746	736_I	746_T	0.3185	0.938	0.888	10
337	347	337_M	347_L	0.3184	0.938	0.888	10
321	353	321_A	353_V	0.318	0.937	0.887	32
256	260	256_L	260_Y	0.3178	0.936	0.886	4
764	787	764_I	787_L	0.3177	0.936	0.886	23
484	488	484_A	488_F	0.3174	0.935	0.886	4
277	280	277_E	280_S	0.3172	0.934	0.885	3
303	307	303_Q	307_Q	0.3168	0.933	0.884	4
149	153	149_I	153_N	0.3163	0.932	0.883	4
605	624	605_A	624_L	0.3163	0.932	0.883	19
268	290	268_L	290_I	0.3163	0.932	0.883	22
365	369	365_A	369_N	0.3162	0.932	0.883	4
510	522	510_A	522_F	0.3158	0.93	0.882	12
507	511	507_L	511_Q	0.3158	0.93	0.882	4
519	547	519_Y	547_D	0.3155	0.93	0.882	28
251	273	251_D	273_R	0.3149	0.928	0.881	22
222	234	222_L	234_I	0.3147	0.927	0.88	12
154	158	154_A	158_K	0.3141	0.926	0.879	4
197	221	197_F	221_A	0.314	0.925	0.878	24
361	365	361_Q	365_A	0.3134	0.923	0.877	4
180	203	180_N	203_A	0.313	0.922	0.876	23
620	623	620_K	623_K	0.3128	0.922	0.876	3
717	749	717_Y	749_L	0.3125	0.921	0.875	32
618	642	618_D	642_L	0.3124	0.92	0.875	24
331	335	331_V	335_T	0.312	0.919	0.874	4
185	200	185_V	200_F	0.312	0.919	0.874	15
606	610	606_I	610_N	0.3117	0.918	0.873	4
682	686	682_N	686_I	0.3116	0.918	0.873	4
731	734	731_L	734_S	0.3111	0.917	0.872	3
332	335	332_A	335_T	0.311	0.916	0.872	3
374	377	374_D	377_R	0.3109	0.916	0.872	3
148	170	148_M	170_Q	0.3106	0.915	0.871	22
259	271	259_Y	271_L	0.3104	0.914	0.87	12
257	261	257_I	261_K	0.3102	0.914	0.87	4
748	783	748_F	783_A	0.3097	0.912	0.869	35
433	459	433_A	459_S	0.3094	0.912	0.869	26
204	214	204_I	214_A	0.3093	0.911	0.868	10
519	544	519_Y	544_K	0.3093	0.911	0.868	25
457	483	457_N	483_L	0.309	0.91	0.867	26
182	185	182_N	185_V	0.309	0.91	0.867	3
753	757	753_A	757_A	0.3071	0.905	0.863	4
525	535	525_S	535_A	0.307	0.904	0.862	10
201	205	201_K	205_A	0.3069	0.904	0.862	4
725	753	725_Y	753_A	0.3063	0.902	0.86	28
476	508	476_A	508_T	0.3059	0.901	0.86	32
310	336	310_F	336_A	0.3051	0.899	0.858	26
765	768	765_A	768_Q	0.3049	0.898	0.857	3
180	202	180_N	202_K	0.3048	0.898	0.857	22
747	770	747_L	770_S	0.3048	0.898	0.857	23
303	306	303_Q	306_S	0.3047	0.898	0.857	3
558	562	558_L	562_A	0.3047	0.898	0.857	4
744	770	744_T	770_S	0.3046	0.897	0.856	26
631	634	631_D	634_A	0.3042	0.896	0.855	3
453	478	453_G	478_N	0.304	0.896	0.855	25
329	353	329_A	353_V	0.3039	0.895	0.855	24
575	579	575_M	579_V	0.3039	0.895	0.855	4
537	556	537_A	556_E	0.3033	0.894	0.854	19
716	728	716_A	728_A	0.3026	0.892	0.852	12
651	655	651_Y	655_A	0.3023	0.891	0.851	4
399	402	399_V	402_N	0.302	0.89	0.85	3
165	187	165_L	187_Q	0.3016	0.889	0.849	22
196	200	196_A	200_F	0.3015	0.888	0.849	4
228	261	228_E	261_K	0.3012	0.887	0.848	33
455	458	455_Y	458_T	0.3007	0.886	0.847	3
503	507	503_Y	507_L	0.3004	0.885	0.846	4
635	654	635_N	654_N	0.3003	0.885	0.846	19
713	717	713_Q	717_Y	0.2996	0.883	0.844	4
340	343	340_E	343_F	0.2994	0.882	0.843	3
219	223	219_V	223_K	0.2993	0.882	0.843	4
188	216	188_M	216_N	0.2991	0.881	0.842	28
290	294	290_I	294_M	0.298	0.878	0.839	4
777	780	777_N	780_S	0.2977	0.877	0.839	3
334	362	334_S	362_D	0.2972	0.876	0.838	28
458	462	458_T	462_L	0.2972	0.875	0.837	4
441	445	441_N	445_F	0.2969	0.875	0.837	4
532	535	532_N	535_A	0.2968	0.874	0.836	3
365	368	365_A	368_Q	0.2967	0.874	0.836	3
720	725	720_I	725_Y	0.2966	0.874	0.836	5
489	517	489_Q	517_L	0.296	0.872	0.834	28
468	491	468_K	491_L	0.2957	0.871	0.833	23
444	456	444_D	456_L	0.2956	0.871	0.833	12
152	164	152_A	164_A	0.2953	0.87	0.832	12
712	735	712_L	735_L	0.2949	0.869	0.831	23
782	786	782_A	786_M	0.2949	0.869	0.831	4
740	743	740_G	743_D	0.2949	0.869	0.831	3
184	199	184_G	199_S	0.2947	0.868	0.83	15
315	318	315_S	318_L	0.2945	0.868	0.83	3
694	722	694_R	722_A	0.2941	0.866	0.828	28
220	224	220_C	224_L	0.2941	0.866	0.828	4
541	560	541_F	560_N	0.2937	0.865	0.827	19
172	179	172_A	179_S	0.2924	0.862	0.824	7
185	189	185_V	189_N	0.2922	0.861	0.823	4
288	300	288_A	300_A	0.2921	0.861	0.823	12
166	169	166_K	169_E	0.292	0.86	0.822	3
352	367	352_L	367_L	0.2917	0.86	0.822	15
270	273	270_M	273_R	0.2915	0.859	0.821	3
699	702	699_E	702_N	0.291	0.857	0.819	3
498	501	498_H	501_L	0.2899	0.854	0.816	3
156	186	156_Y	186_S	0.2896	0.853	0.815	30
624	627	624_L	627_E	0.2891	0.852	0.814	3
259	264	259_Y	264_Y	0.2887	0.851	0.813	5
216	219	216_N	219_V	0.2887	0.851	0.813	3
298	302	298_S	302_Q	0.2885	0.85	0.812	4
460	468	460_K	468_K	0.2881	0.849	0.811	8
518	522	518_A	522_F	0.2881	0.849	0.811	4
617	621	617_V	621_I	0.2881	0.849	0.811	4
265	269	265_P	269_Q	0.288	0.849	0.811	4
752	767	752_V	767_L	0.2877	0.848	0.81	15
677	696	677_R	696_K	0.2873	0.847	0.809	19
280	283	280_S	283_A	0.2872	0.846	0.808	3
231	258	231_R	258_N	0.2869	0.845	0.807	27
440	455	440_A	455_Y	0.2868	0.845	0.807	15
222	253	222_L	253_Y	0.2864	0.844	0.805	31
680	696	680_Y	696_K	0.2863	0.844	0.805	16
490	494	490_K	494_D	0.2854	0.841	0.802	4
330	359	330_K	359_N	0.2851	0.84	0.801	29
231	261	231_R	261_K	0.285	0.84	0.801	30
362	366	362_D	366_R	0.2848	0.839	0.8	4
292	319	292_A	319_L	0.2843	0.838	0.799	27
492	502	492_I	502_H	0.284	0.837	0.798	10
551	554	551_T	554_Y	0.284	0.837	0.798	3
720	753	720_I	753_A	0.2836	0.835	0.796	33
602	637	602_I	637_L	0.2836	0.835	0.796	35
699	703	699_E	703_V	0.2834	0.835	0.796	4
700	703	700_L	703_V	0.2831	0.834	0.795	3
167	171	167_V	171_V	0.2819	0.83	0.79	4
292	297	292_A	297_D	0.2814	0.829	0.789	5
255	267	255_S	267_A	0.2812	0.828	0.788	12
285	289	285_Y	289_K	0.2811	0.828	0.788	4
218	233	218_A	233_Y	0.2808	0.827	0.787	15
156	182	156_Y	182_N	0.2807	0.827	0.787	26
292	304	292_A	304_L	0.2803	0.826	0.785	12
743	746	743_D	746_T	0.2799	0.825	0.784	3
764	788	764_I	788_Y	0.2794	0.823	0.782	24
230	257	230_F	257_I	0.2787	0.821	0.78	27
215	219	215_I	219_V	0.2786	0.821	0.78	4
693	697	693_E	697_I	0.2777	0.818	0.776	4
553	557	553_L	557_I	0.2776	0.818	0.776	4
252	286	252_Y	286_L	0.2775	0.818	0.776	34
691	722	691_N	722_A	0.2772	0.817	0.775	31
232	235	232_Y	235_D	0.2766	0.815	0.772	3
694	719	694_R	719_D	0.2766	0.815	0.772	25
204	213	204_I	213_A	0.2759	0.813	0.77	9
602	605	602_I	605_A	0.2752	0.811	0.768	3
153	157	153_N	157_L	0.274	0.807	0.763	4
251	274	251_D	274_T	0.2738	0.807	0.763	23
285	315	285_Y	315_S	0.2737	0.806	0.761	30
601	620	601_L	620_K	0.2736	0.806	0.761	19
652	680	652_A	680_Y	0.2731	0.805	0.76	28
267	271	267_A	271_L	0.2727	0.804	0.759	4
153	182	153_N	182_N	0.2727	0.803	0.758	29
460	471	460_K	471_N	0.2725	0.803	0.758	11
551	555	551_T	555_N	0.2725	0.803	0.758	4
248	274	248_K	274_T	0.2718	0.801	0.755	26
172	180	172_A	180_N	0.2717	0.8	0.754	8
579	585	579_V	585_S	0.2714	0.799	0.752	6
691	695	691_N	695_Q	0.2711	0.799	0.752	4
517	521	517_L	521_H	0.271	0.799	0.752	4
476	504	476_A	504_N	0.2709	0.798	0.751	28
169	195	169_E	195_E	0.2708	0.798	0.751	26
149	152	149_I	152_A	0.2707	0.798	0.751	3
751	763	751_A	763_A	0.2704	0.797	0.75	12
473	477	473_I	477_L	0.2703	0.796	0.749	4
519	543	519_Y	543_A	0.2698	0.795	0.747	24
690	718	690_L	718_L	0.2696	0.794	0.746	28
331	334	331_V	334_S	0.2696	0.794	0.746	3
184	196	184_G	196_A	0.2696	0.794	0.746	12
717	732	717_Y	732_Y	0.2693	0.793	0.745	15
167	170	167_V	170_Q	0.2691	0.793	0.745	3
436	459	436_Y	459_S	0.2691	0.793	0.745	23
618	645	618_D	645_N	0.2683	0.79	0.741	27
695	698	695_Q	698_K	0.2683	0.79	0.741	3
747	769	747_L	769_L	0.268	0.789	0.739	22
286	289	286_L	289_K	0.2678	0.789	0.739	3
516	520	516_E	520_K	0.2675	0.788	0.738	4
678	711	678_E	711_I	0.2672	0.787	0.737	33
752	756	752_V	756_G	0.267	0.787	0.737	4
508	512	508_T	512_M	0.2662	0.784	0.733	4
727	731	727_E	731_L	0.2653	0.782	0.73	4
767	771	767_L	771_K	0.2651	0.781	0.729	4
332	336	332_A	336_A	0.2648	0.78	0.727	4
504	507	504_N	507_L	0.2647	0.78	0.727	3
360	364	360_Y	364_L	0.2646	0.78	0.727	4
785	797	785_G	797_A	0.2644	0.779	0.726	12
252	256	252_Y	256_L	0.2643	0.779	0.726	4
764	791	764_I	791_V	0.2641	0.778	0.725	27
656	680	656_Q	680_Y	0.2639	0.778	0.725	24
437	470	437_I	470_A	0.2638	0.777	0.723	33
502	528	502_H	528_L	0.2637	0.777	0.723	26
444	474	444_D	474_N	0.2635	0.776	0.722	30
781	803	781_K	803_T	0.2632	0.775	0.721	22
455	459	455_Y	459_S	0.2629	0.775	0.721	4
653	656	653_Q	656_Q	0.2627	0.774	0.719	3
193	220	193_F	220_C	0.2626	0.774	0.719	27
771	781	771_K	781_K	0.2626	0.774	0.719	10
621	625	621_I	625_R	0.2625	0.773	0.718	4
614	641	614_N	641_S	0.2621	0.772	0.716	27
452	456	452_A	456_L	0.262	0.772	0.716	4
449	474	449_S	474_N	0.262	0.772	0.716	25
768	796	768_Q	796_A	0.2619	0.771	0.715	28
259	286	259_Y	286_L	0.2616	0.771	0.715	27
507	539	507_L	539_A	0.2616	0.771	0.715	32
368	439	368_Q	439_K	0.2616	0.771	0.715	71
233	236	233_Y	236_L	0.2614	0.77	0.714	3
222	227	222_L	227_K	0.2613	0.77	0.714	5
188	220	188_M	220_C	0.2612	0.77	0.714	32
307	312	307_Q	312_S	0.2607	0.768	0.711	5
731	735	731_L	735_L	0.2606	0.768	0.711	4
270	274	270_M	274_T	0.2605	0.768	0.711	4
314	343	314_L	343_F	0.2605	0.767	0.709	29
619	623	619_V	623_K	0.2604	0.767	0.709	4
639	651	639_F	651_Y	0.2604	0.767	0.709	12
156	161	156_Y	161_V	0.2604	0.767	0.709	5
782	785	782_A	785_G	0.2603	0.767	0.709	3
640	644	640_N	644_S	0.2603	0.767	0.709	4
665	668	665_D	668_S	0.2603	0.767	0.709	3
787	791	787_L	791_V	0.26	0.766	0.708	4
748	752	748_F	752_V	0.2596	0.765	0.706	4
636	640	636_I	640_N	0.2594	0.764	0.705	4
483	487	483_L	487_E	0.2592	0.764	0.705	4
529	532	529_N	532_N	0.259	0.763	0.704	3
717	721	717_Y	721_F	0.2587	0.762	0.702	4
349	352	349_A	352_L	0.2581	0.76	0.699	3
725	757	725_Y	757_A	0.2579	0.76	0.699	32
219	234	219_V	234_I	0.2575	0.759	0.698	15
288	303	288_A	303_Q	0.2575	0.759	0.698	15
728	732	728_A	732_Y	0.2573	0.758	0.696	4
197	226	197_F	226_D	0.2572	0.758	0.696	29
149	182	149_I	182_N	0.2571	0.758	0.696	33
161	186	161_V	186_S	0.2571	0.757	0.695	25
657	663	657_I	663_K	0.2569	0.757	0.695	6
451	455	451_D	455_Y	0.2569	0.757	0.695	4
746	749	746_T	749_L	0.2568	0.756	0.694	3
231	257	231_R	257_I	0.2566	0.756	0.694	26
602	606	602_I	606_I	0.2566	0.756	0.694	4
609	621	609_K	621_I	0.2564	0.755	0.692	12
241	244	241_L	244_E	0.2556	0.753	0.689	3
720	749	720_I	749_L	0.2553	0.752	0.688	29
729	759	729_Y	759_N	0.2552	0.752	0.688	30
678	714	678_E	714_T	0.2551	0.752	0.688	36
537	560	537_A	560_N	0.2547	0.751	0.686	23
232	236	232_Y	236_L	0.2546	0.75	0.685	4
755	760	755_I	760_P	0.2544	0.749	0.683	5
800	803	800_Q	803_T	0.2544	0.749	0.683	3
521	524	521_H	524_S	0.254	0.748	0.682	3
188	193	188_M	193_F	0.2537	0.747	0.68	5
353	357	353_V	357_T	0.2531	0.746	0.679	4
602	634	602_I	634_A	0.253	0.745	0.677	32
510	515	510_A	515_Y	0.2528	0.745	0.677	5
625	635	625_R	635_N	0.2528	0.745	0.677	10
271	287	271_L	287_S	0.2527	0.745	0.677	16
148	174	148_M	174_Y	0.2527	0.744	0.676	26
698	702	698_K	702_N	0.2525	0.744	0.676	4
144	147	144_R	147_G	0.2523	0.743	0.674	3
487	490	487_E	490_K	0.2521	0.743	0.674	3
363	367	363_M	367_L	0.2516	0.741	0.671	4
555	559	555_N	559_D	0.2515	0.741	0.671	4
194	198	194_Q	198_E	0.2508	0.739	0.668	4
141	144	141_D	144_R	0.2507	0.738	0.667	3
302	305	302_Q	305_N	0.2505	0.738	0.667	3
196	220	196_A	220_C	0.2489	0.733	0.659	24
215	253	215_I	253_Y	0.2489	0.733	0.659	38
473	488	473_I	488_F	0.2487	0.733	0.659	15
470	473	470_A	473_I	0.2487	0.733	0.659	3
253	256	253_Y	256_L	0.2485	0.732	0.657	3
789	794	789_Q	794_Y	0.2485	0.732	0.657	5
179	182	179_S	182_N	0.2484	0.732	0.657	3
321	349	321_A	349_A	0.2481	0.731	0.656	28
348	352	348_A	352_L	0.2479	0.73	0.654	4
333	337	333_L	337_M	0.2473	0.729	0.653	4
474	478	474_N	478_N	0.2472	0.728	0.651	4
783	786	783_A	786_M	0.247	0.728	0.651	3
454	457	454_V	457_N	0.2467	0.727	0.65	3
314	318	314_L	318_L	0.2467	0.727	0.65	4
199	203	199_S	203_A	0.2466	0.727	0.65	4
181	216	181_Y	216_N	0.2464	0.726	0.648	35
515	543	515_Y	543_A	0.2459	0.725	0.647	28
748	780	748_F	780_S	0.2457	0.724	0.645	32
150	153	150_Q	153_N	0.2457	0.724	0.645	3
267	290	267_A	290_I	0.245	0.722	0.642	23
616	620	616_Q	620_K	0.2447	0.721	0.64	4
271	290	271_L	290_I	0.2446	0.721	0.64	19
800	804	800_Q	804_L	0.2445	0.72	0.639	4
297	323	297_D	323_I	0.2445	0.72	0.639	26
199	202	199_S	202_K	0.2441	0.719	0.637	3
761	791	761_N	791_V	0.2437	0.718	0.635	30
605	620	605_A	620_K	0.2436	0.718	0.635	15
469	473	469_I	473_I	0.2431	0.716	0.632	4
334	337	334_S	337_M	0.2425	0.715	0.631	3
600	603	600_S	603_F	0.2424	0.714	0.629	3
641	645	641_S	645_N	0.2423	0.714	0.629	4
728	753	728_A	753_A	0.2421	0.713	0.627	25
152	167	152_A	167_V	0.2421	0.713	0.627	15
292	300	292_A	300_A	0.2417	0.712	0.626	8
326	357	326_Y	357_T	0.2414	0.711	0.624	31
485	514	485_N	514_N	0.2412	0.711	0.624	29
269	273	269_Q	273_R	0.2412	0.711	0.624	4
318	321	318_L	321_A	0.2406	0.709	0.621	3
601	605	601_L	605_A	0.2406	0.709	0.621	4
523	552	523_S	552_K	0.2405	0.709	0.621	29
487	491	487_E	491_L	0.2405	0.708	0.619	4
450	454	450_A	454_V	0.2403	0.708	0.619	4
193	197	193_F	197_F	0.2402	0.708	0.619	4
635	657	635_N	657_I	0.2401	0.707	0.618	22
171	174	171_V	174_Y	0.2401	0.707	0.618	3
620	624	620_K	624_L	0.24	0.707	0.618	4
153	178	153_N	178_L	0.2398	0.706	0.616	25
766	770	766_L	770_S	0.2398	0.706	0.616	4
755	763	755_I	763_A	0.2398	0.706	0.616	8
460	467	460_K	467_V	0.2396	0.706	0.616	7
484	508	484_A	508_T	0.2393	0.705	0.615	24
436	462	436_Y	462_L	0.2386	0.703	0.611	26
305	328	305_N	328_K	0.2384	0.702	0.61	23
556	559	556_E	559_D	0.2379	0.701	0.608	3
503	532	503_Y	532_N	0.2376	0.7	0.606	29
347	373	347_L	373_N	0.2375	0.7	0.606	26
210	213	210_Q	213_A	0.2374	0.699	0.605	3
256	271	256_L	271_L	0.2371	0.698	0.603	15
321	356	321_A	356_K	0.237	0.698	0.603	35
698	727	698_K	727_E	0.237	0.698	0.603	29
768	771	768_Q	771_K	0.2365	0.697	0.601	3
555	558	555_N	558_L	0.2363	0.696	0.6	3
762	766	762_S	766_L	0.2362	0.696	0.6	4
272	275	272_Q	275_D	0.2361	0.696	0.6	3
308	312	308_G	312_S	0.2361	0.696	0.6	4
714	717	714_T	717_Y	0.236	0.695	0.598	3
520	523	520_K	523_S	0.2358	0.695	0.598	3
237	250	237_A	250_Y	0.2357	0.694	0.596	13
678	681	678_E	681_V	0.2356	0.694	0.596	3
600	604	600_S	604_E	0.2354	0.694	0.596	4
437	441	437_I	441_N	0.2353	0.693	0.595	4
367	371	367_L	371_Y	0.2352	0.693	0.595	4
560	563	560_N	563_A	0.2351	0.693	0.595	3
147	150	147_G	150_Q	0.2351	0.693	0.595	3
459	462	459_S	462_L	0.2351	0.693	0.595	3
214	240	214_A	240_Y	0.235	0.692	0.593	26
643	655	643_N	655_A	0.235	0.692	0.593	12
770	773	770_S	773_T	0.2348	0.692	0.593	3
318	333	318_L	333_L	0.2345	0.691	0.592	15
619	622	619_V	622_A	0.2344	0.691	0.592	3
684	696	684_M	696_K	0.2341	0.69	0.59	12
700	711	700_L	711_I	0.2339	0.689	0.588	11
542	546	542_C	546_I	0.2338	0.689	0.588	4
526	537	526_Y	537_A	0.2327	0.686	0.583	11
720	756	720_I	756_G	0.2324	0.685	0.582	36
796	800	796_A	800_Q	0.2324	0.685	0.582	4
456	471	456_L	471_N	0.2322	0.684	0.58	15
147	151	147_G	151_K	0.2321	0.684	0.58	4
368	457	368_Q	457_N	0.2319	0.683	0.578	89
452	474	452_A	474_N	0.2317	0.683	0.578	22
300	319	300_A	319_L	0.2315	0.682	0.576	19
726	729	726_E	729_Y	0.2312	0.681	0.575	3
299	303	299_K	303_Q	0.2311	0.681	0.575	4
309	312	309_N	312_S	0.2311	0.681	0.575	3
676	680	676_A	680_Y	0.2309	0.68	0.573	4
726	730	726_E	730_A	0.2307	0.68	0.573	4
781	785	781_K	785_G	0.2306	0.68	0.573	4
444	470	444_D	470_A	0.2306	0.679	0.571	26
781	804	781_K	804_L	0.2304	0.679	0.571	23
204	217	204_I	217_A	0.2303	0.679	0.571	13
304	316	304_L	316_L	0.2302	0.678	0.57	12
718	722	718_L	722_A	0.2301	0.678	0.57	4
222	257	222_L	257_I	0.2301	0.678	0.57	35
488	505	488_F	505_L	0.2301	0.678	0.57	17
450	453	450_A	453_G	0.2299	0.677	0.568	3
725	756	725_Y	756_G	0.2298	0.677	0.568	31
233	237	233_Y	237_A	0.2295	0.676	0.566	4
289	315	289_K	315_S	0.2293	0.676	0.566	26
200	220	200_F	220_C	0.2291	0.675	0.565	20
635	658	635_N	658_H	0.2289	0.674	0.563	23
550	553	550_T	553_L	0.2289	0.674	0.563	3
337	350	337_M	350_L	0.2288	0.674	0.563	13
697	701	697_I	701_I	0.2287	0.674	0.563	4
163	167	163_Q	167_V	0.2287	0.674	0.563	4
716	753	716_A	753_A	0.2285	0.673	0.561	37
327	331	327_A	331_V	0.2284	0.673	0.561	4
717	720	717_Y	720_I	0.2283	0.673	0.561	3
683	687	683_L	687_A	0.2283	0.672	0.56	4
443	446	443_T	446_V	0.228	0.672	0.56	3
749	752	749_L	752_V	0.2278	0.671	0.558	3
264	294	264_Y	294_M	0.2277	0.671	0.558	30
704	707	704_S	707_K	0.2277	0.671	0.558	3
752	783	752_V	783_A	0.2276	0.67	0.556	31
234	238	234_I	238_Q	0.2273	0.67	0.556	4
489	509	489_Q	509_Y	0.2273	0.67	0.556	20
366	370	366_R	370_S	0.2272	0.669	0.555	4
779	783	779_E	783_A	0.2271	0.669	0.555	4
799	803	799_S	803_T	0.2271	0.669	0.555	4
289	304	289_K	304_L	0.2269	0.668	0.553	15
656	692	656_Q	692_L	0.2266	0.668	0.553	36
438	441	438_K	441_N	0.2264	0.667	0.551	3
615	618	615_N	618_D	0.2264	0.667	0.551	3
649	653	649_K	653_Q	0.2263	0.667	0.551	4
760	787	760_P	787_L	0.2257	0.665	0.548	27
162	166	162_E	166_K	0.2256	0.665	0.548	4
398	401	398_A	401_Q	0.2254	0.664	0.546	3
256	286	256_L	286_L	0.2248	0.662	0.543	30
310	314	310_F	314_L	0.2246	0.662	0.543	4
155	158	155_L	158_K	0.2244	0.661	0.541	3
640	679	640_N	679_F	0.2242	0.661	0.541	39
370	373	370_S	373_N	0.2241	0.66	0.539	3
643	648	643_N	648_I	0.224	0.66	0.539	5
444	449	444_D	449_S	0.2239	0.66	0.539	5
500	504	500_I	504_N	0.2239	0.66	0.539	4
748	751	748_F	751_A	0.2238	0.659	0.538	3
161	165	161_V	165_L	0.2238	0.659	0.538	4
605	617	605_A	617_V	0.2237	0.659	0.538	12
185	216	185_V	216_N	0.2236	0.659	0.538	31
732	753	732_Y	753_A	0.2236	0.659	0.538	21
637	640	637_L	640_N	0.2235	0.658	0.536	3
449	453	449_S	453_G	0.2234	0.658	0.536	4
720	732	720_I	732_Y	0.2234	0.658	0.536	12
188	196	188_M	196_A	0.2232	0.657	0.534	8
172	183	172_A	183_L	0.2231	0.657	0.534	11
265	268	265_P	268_L	0.223	0.657	0.534	3
522	526	522_F	526_Y	0.2224	0.655	0.531	4
273	276	273_R	276_M	0.2222	0.655	0.531	3
608	617	608_A	617_V	0.2222	0.655	0.531	9
238	251	238_Q	251_D	0.2219	0.654	0.529	13
281	284	281_D	284_K	0.2216	0.653	0.527	3
181	203	181_Y	203_A	0.2215	0.653	0.527	22
313	335	313_S	335_T	0.2215	0.653	0.527	22
321	329	321_A	329_A	0.2213	0.652	0.526	8
598	624	598_P	624_L	0.2211	0.651	0.524	26
658	664	658_H	664_L	0.2211	0.651	0.524	6
635	639	635_N	639_F	0.221	0.651	0.524	4
436	502	436_Y	502_H	0.221	0.651	0.524	66
615	619	615_N	619_V	0.2209	0.651	0.524	4
600	605	600_S	605_A	0.2209	0.651	0.524	5
607	611	607_V	611_N	0.2208	0.65	0.522	4
201	221	201_K	221_A	0.2208	0.65	0.522	20
786	790	786_M	790_E	0.2206	0.65	0.522	4
492	505	492_I	505_L	0.2205	0.65	0.522	13
269	302	269_Q	302_Q	0.2204	0.649	0.52	33
313	336	313_S	336_A	0.2199	0.648	0.519	23
605	608	605_A	608_A	0.2199	0.648	0.519	3
794	798	794_Y	798_I	0.2198	0.648	0.519	4
308	313	308_G	313_S	0.2197	0.647	0.517	5
533	560	533_Y	560_N	0.2194	0.646	0.515	27
177	180	177_S	180_N	0.2192	0.646	0.515	3
537	559	537_A	559_D	0.2189	0.645	0.514	22
652	684	652_A	684_M	0.2184	0.643	0.51	32
201	229	201_K	229_K	0.2184	0.643	0.51	28
676	679	676_A	679_F	0.2182	0.643	0.51	3
488	508	488_F	508_T	0.2181	0.643	0.51	20
184	216	184_G	216_N	0.218	0.642	0.508	32
651	658	651_Y	658_H	0.2179	0.642	0.508	7
735	738	735_L	738_D	0.2179	0.642	0.508	3
507	522	507_L	522_F	0.2175	0.641	0.507	15
713	745	713_Q	745_K	0.2175	0.641	0.507	32
516	519	516_E	519_Y	0.2174	0.641	0.507	3
649	652	649_K	652_A	0.2172	0.64	0.505	3
227	257	227_K	257_I	0.2171	0.64	0.505	30
211	215	211_S	215_I	0.217	0.639	0.503	4
481	512	481_L	512_M	0.2169	0.639	0.503	31
441	456	441_N	456_L	0.2168	0.639	0.503	15
752	786	752_V	786_M	0.2165	0.638	0.502	34
265	296	265_P	296_F	0.2163	0.637	0.5	31
281	309	281_D	309_N	0.2161	0.637	0.5	28
544	553	544_K	553_L	0.2161	0.637	0.5	9
400	404	400_A	404_F	0.2159	0.636	0.498	4
469	498	469_I	498_H	0.2159	0.636	0.498	29
297	319	297_D	319_L	0.2156	0.635	0.496	22
234	257	234_I	257_I	0.2156	0.635	0.496	23
442	446	442_V	446_V	0.2151	0.634	0.495	4
778	804	778_K	804_L	0.2151	0.634	0.495	26
472	504	472_I	504_N	0.215	0.633	0.493	32
168	172	168_Y	172_A	0.2149	0.633	0.493	4
334	457	334_S	457_N	0.2147	0.633	0.493	123
481	485	481_L	485_N	0.2146	0.632	0.491	4
292	315	292_A	315_S	0.2145	0.632	0.491	23
658	676	658_H	676_A	0.2143	0.631	0.49	18
577	581	577_F	581_N	0.2143	0.631	0.49	4
269	272	269_Q	272_Q	0.2142	0.631	0.49	3
697	715	697_I	715_L	0.2141	0.631	0.49	18
654	657	654_N	657_I	0.214	0.63	0.488	3
604	607	604_E	607_V	0.2138	0.63	0.488	3
177	210	177_S	210_Q	0.2137	0.63	0.488	33
476	481	476_A	481_L	0.2134	0.629	0.486	5
700	705	700_L	705_G	0.2133	0.629	0.486	5
639	654	639_F	654_N	0.2131	0.628	0.484	15
197	200	197_F	200_F	0.2129	0.627	0.483	3
526	535	526_Y	535_A	0.2127	0.627	0.483	9
489	523	489_Q	523_S	0.2127	0.627	0.483	34
321	326	321_A	326_Y	0.2126	0.626	0.481	5
636	676	636_I	676_A	0.2125	0.626	0.481	40
622	733	622_A	733_N	0.2124	0.626	0.481	111
752	755	752_V	755_I	0.212	0.625	0.479	3
145	148	145_I	148_M	0.212	0.625	0.479	3
456	522	456_L	522_F	0.2119	0.624	0.478	66
486	489	486_Q	489_Q	0.2118	0.624	0.478	3
367	488	367_L	488_F	0.2118	0.624	0.478	121
482	485	482_R	485_N	0.2117	0.624	0.478	3
553	560	553_L	560_N	0.2117	0.624	0.478	7
696	699	696_K	699_E	0.2116	0.623	0.476	3
606	609	606_I	609_K	0.2115	0.623	0.476	3
719	722	719_D	722_A	0.2114	0.623	0.476	3
164	186	164_A	186_S	0.2113	0.622	0.474	22
351	366	351_T	366_R	0.2106	0.62	0.471	15
543	547	543_A	547_D	0.2104	0.62	0.471	4
473	476	473_I	476_A	0.21	0.619	0.469	3
228	232	228_E	232_Y	0.2097	0.618	0.467	4
286	315	286_L	315_S	0.2095	0.617	0.466	29
366	487	366_R	487_E	0.2095	0.617	0.466	121
632	658	632_I	658_H	0.2092	0.616	0.464	26
537	541	537_A	541_F	0.2091	0.616	0.464	4
469	500	469_I	500_I	0.209	0.616	0.464	31
348	435	348_A	435_L	0.2089	0.615	0.462	87
200	213	200_F	213_A	0.2088	0.615	0.462	13
259	267	259_Y	267_A	0.2088	0.615	0.462	8
799	802	799_S	802_K	0.2084	0.614	0.46	3
184	213	184_G	213_A	0.2083	0.614	0.46	29
235	266	235_D	266_E	0.2083	0.614	0.46	31
156	164	156_Y	164_A	0.2082	0.613	0.459	8
264	268	264_Y	268_L	0.2082	0.613	0.459	4
144	148	144_R	148_M	0.208	0.613	0.459	4
548	553	548_I	553_L	0.2079	0.612	0.457	5
298	325	298_S	325_E	0.2076	0.612	0.457	27
453	519	453_G	519_Y	0.2073	0.611	0.455	66
646	651	646_L	651_Y	0.2073	0.611	0.455	5
495	501	495_Y	501_L	0.2072	0.61	0.454	6
444	452	444_D	452_A	0.2071	0.61	0.454	8
606	637	606_I	637_L	0.207	0.61	0.454	31
475	478	475_Y	478_N	0.2069	0.61	0.454	3
526	540	526_Y	540_M	0.2066	0.609	0.452	14
180	284	180_N	284_K	0.2066	0.609	0.452	104
510	518	510_A	518_A	0.2064	0.608	0.45	8
539	543	539_A	543_A	0.2063	0.608	0.45	4
552	556	552_K	556_E	0.2061	0.607	0.449	4
692	696	692_L	696_K	0.2057	0.606	0.447	4
681	693	681_V	693_E	0.2055	0.606	0.447	12
402	406	402_N	406_K	0.2055	0.605	0.445	4
468	494	468_K	494_D	0.2054	0.605	0.445	26
523	622	523_S	622_A	0.2053	0.605	0.445	99
542	545	542_C	545_L	0.2052	0.604	0.443	3
215	285	215_I	285_Y	0.2051	0.604	0.443	70
798	801	798_I	801_Y	0.2048	0.603	0.442	3
614	618	614_N	618_D	0.2047	0.603	0.442	4
516	547	516_E	547_D	0.2045	0.603	0.442	31
713	735	713_Q	735_L	0.2041	0.601	0.438	22
156	185	156_Y	185_V	0.2041	0.601	0.438	29
636	679	636_I	679_F	0.2038	0.601	0.438	43
336	339	336_A	339_I	0.2038	0.6	0.437	3
537	563	537_A	563_A	0.2038	0.6	0.437	26
455	521	455_Y	521_H	0.2036	0.6	0.437	66
549	553	549_D	553_L	0.2033	0.599	0.435	4
568	571	568_K	571_M	0.2032	0.599	0.435	3
649	687	649_K	687_A	0.2031	0.598	0.433	38
527	626	527_H	626_S	0.2031	0.598	0.433	99
355	363	355_I	363_M	0.203	0.598	0.433	8
640	643	640_N	643_N	0.2029	0.598	0.433	3
340	346	340_E	346_S	0.2027	0.597	0.432	6
180	206	180_N	206_N	0.2023	0.596	0.43	26
668	676	668_S	676_A	0.2021	0.595	0.428	8
457	475	457_N	475_Y	0.2016	0.594	0.427	18
177	181	177_S	181_Y	0.2014	0.593	0.425	4
229	233	229_K	233_Y	0.2014	0.593	0.425	4
614	645	614_N	645_N	0.2013	0.593	0.425	31
732	736	732_Y	736_I	0.2012	0.593	0.425	4
685	690	685_H	690_L	0.2009	0.592	0.423	5
300	304	300_A	304_L	0.2009	0.592	0.423	4
266	270	266_E	270_M	0.2008	0.592	0.423	4
181	210	181_Y	210_Q	0.2007	0.591	0.422	29
255	283	255_S	283_A	0.2007	0.591	0.422	28
662	676	662_L	676_A	0.2006	0.591	0.422	14
198	201	198_E	201_K	0.2006	0.591	0.422	3
364	439	364_L	439_K	0.2003	0.59	0.42	75
677	699	677_R	699_E	0.1999	0.589	0.418	22
234	250	234_I	250_Y	0.1998	0.589	0.418	16
297	301	297_D	301_I	0.1996	0.588	0.417	4
215	218	215_I	218_A	0.1996	0.588	0.417	3
304	308	304_L	308_G	0.1996	0.588	0.417	4
355	360	355_I	360_Y	0.1995	0.588	0.417	5
755	783	755_I	783_A	0.1991	0.587	0.415	28
180	251	180_N	251_D	0.199	0.586	0.413	71
372	461	372_D	461_A	0.1988	0.586	0.413	89
447	513	447_D	513_Q	0.1987	0.585	0.412	66
161	190	161_V	190_E	0.1985	0.585	0.412	29
399	403	399_V	403_S	0.1984	0.585	0.412	4
487	620	487_E	620_K	0.1983	0.584	0.41	133
271	333	271_L	333_L	0.1981	0.584	0.41	62
648	651	648_I	651_Y	0.198	0.583	0.408	3
366	521	366_R	521_H	0.198	0.583	0.408	155
503	506	503_Y	506_A	0.198	0.583	0.408	3
314	336	314_L	336_A	0.1978	0.583	0.408	22
272	291	272_Q	291_Y	0.1974	0.582	0.407	19
601	624	601_L	624_L	0.1972	0.581	0.405	23
326	330	326_Y	330_K	0.1971	0.581	0.405	4
366	455	366_R	455_Y	0.197	0.58	0.403	89
150	154	150_Q	154_A	0.197	0.58	0.403	4
636	639	636_I	639_F	0.1967	0.58	0.403	3
201	204	201_K	204_I	0.1967	0.579	0.402	3
653	657	653_Q	657_I	0.1966	0.579	0.402	4
172	176	172_A	176_E	0.1961	0.578	0.4	4
177	207	177_S	207_G	0.196	0.578	0.4	30
