i	j	i_id	j_id	r_sco	s_sco	prob	distance
480	483	480_K	483_L	1.6579	4.559	1	3
724	727	724_Q	727_E	1.651	4.54	1	3
448	451	448_D	451_D	1.5983	4.395	1	3
514	517	514_N	517_L	1.5941	4.383	1	3
613	616	613_L	616_Q	1.5874	4.365	1	3
759	762	759_N	762_S	1.5779	4.339	1	3
359	362	359_N	362_D	1.5663	4.307	1	3
192	195	192_K	195_E	1.5624	4.296	1	3
296	299	296_F	299_K	1.5505	4.264	1	3
325	328	325_E	328_K	1.5445	4.247	1	3
263	266	263_Y	266_E	1.5406	4.236	1	3
689	692	689_L	692_L	1.4923	4.103	1	3
226	229	226_D	229_K	1.4791	4.067	1	3
160	163	160_E	163_Q	1.4024	3.856	1	3
793	796	793_N	796_A	1.3835	3.804	1	3
396	399	396_N	399_V	1.2958	3.563	1	3
472	488	472_I	488_F	0.8698	2.392	1	16
716	732	716_A	732_Y	0.7884	2.168	1	16
505	521	505_L	521_H	0.7664	2.107	1	16
751	767	751_A	767_L	0.7243	1.992	1	16
506	522	506_A	522_F	0.7238	1.99	1	16
317	333	317_G	333_L	0.7114	1.956	1	16
440	456	440_A	456_L	0.7045	1.937	1	16
184	200	184_G	200_F	0.7044	1.937	1	16
471	487	471_N	487_E	0.6985	1.921	1	16
351	367	351_T	367_L	0.6905	1.899	1	16
502	521	502_H	521_H	0.6852	1.884	1	19
364	368	364_L	368_Q	0.6808	1.872	1	4
519	523	519_Y	523_S	0.6805	1.871	1	4
509	517	509_Y	517_L	0.6754	1.857	1	8
457	471	457_N	471_N	0.6714	1.846	1	14
288	304	288_A	304_L	0.6712	1.846	1	16
489	505	489_Q	505_L	0.6682	1.837	1	16
729	733	729_Y	733_N	0.6588	1.811	1	4
328	331	328_K	331_V	0.657	1.807	1	3
218	234	218_A	234_I	0.6544	1.799	1	16
287	291	287_S	291_Y	0.6493	1.785	1	4
316	320	316_L	320_Y	0.6477	1.781	1	4
618	622	618_D	622_A	0.6476	1.781	1	4
475	483	475_Y	483_L	0.6467	1.778	1	8
604	621	604_E	621_I	0.643	1.768	1	17
255	271	255_S	271_L	0.6416	1.764	1	16
485	489	485_N	489_Q	0.6363	1.75	1	4
183	187	183_L	187_Q	0.6334	1.742	0.999	4
764	768	764_I	768_Q	0.6284	1.728	0.999	4
712	731	712_L	731_L	0.625	1.718	0.999	19
468	487	468_K	487_E	0.6241	1.716	0.999	19
694	698	694_R	698_K	0.6196	1.704	0.999	4
201	217	201_K	217_A	0.6179	1.699	0.999	16
330	334	330_K	334_S	0.6175	1.698	0.999	4
747	766	747_L	766_L	0.6174	1.698	0.999	19
254	258	254_L	258_N	0.615	1.691	0.999	4
750	766	750_A	766_L	0.6129	1.685	0.999	16
603	620	603_F	620_K	0.6086	1.673	0.999	17
350	354	350_L	354_D	0.6069	1.669	0.999	4
616	619	616_Q	619_V	0.6037	1.66	0.999	3
180	199	180_N	199_S	0.5999	1.65	0.999	19
217	221	217_A	221_A	0.5977	1.643	0.999	4
387	404	387_Q	404_F	0.5959	1.639	0.999	17
183	199	183_L	199_S	0.5865	1.613	0.999	16
187	195	187_Q	195_E	0.5857	1.611	0.999	8
715	731	715_L	731_L	0.5819	1.6	0.999	16
187	192	187_Q	192_K	0.5749	1.581	0.998	5
231	235	231_R	235_D	0.5746	1.58	0.998	4
313	332	313_S	332_A	0.5729	1.575	0.998	19
451	454	451_D	454_V	0.5726	1.574	0.998	3
251	270	251_D	270_M	0.5726	1.574	0.998	19
316	332	316_L	332_A	0.5723	1.574	0.998	16
268	272	268_L	272_Q	0.5701	1.568	0.998	4
334	350	334_S	350_L	0.5697	1.566	0.998	16
347	366	347_L	366_R	0.5671	1.559	0.998	19
152	168	152_A	168_Y	0.5665	1.558	0.998	16
715	719	715_L	719_D	0.5648	1.553	0.998	4
471	475	471_N	475_Y	0.5639	1.551	0.998	4
727	730	727_E	730_A	0.5633	1.549	0.998	3
151	155	151_K	155_L	0.5627	1.547	0.998	4
719	724	719_D	724_Q	0.5576	1.533	0.998	5
221	226	221_A	226_D	0.5556	1.528	0.998	5
754	759	754_A	759_N	0.555	1.526	0.998	5
285	312	285_Y	312_S	0.554	1.523	0.998	27
350	366	350_L	366_R	0.5527	1.52	0.998	16
734	737	734_S	737_D	0.5512	1.516	0.998	3
729	753	729_Y	753_A	0.5507	1.514	0.998	24
165	169	165_L	169_E	0.5497	1.512	0.998	4
348	382	348_A	382_D	0.5494	1.511	0.998	34
354	366	354_D	366_R	0.5481	1.507	0.997	12
301	305	301_I	305_N	0.547	1.504	0.997	4
475	480	475_Y	480_K	0.5451	1.499	0.997	5
299	302	299_K	302_Q	0.5441	1.496	0.997	3
383	403	383_A	403_S	0.5435	1.494	0.997	20
169	183	169_E	183_L	0.5424	1.492	0.997	14
762	765	762_S	765_A	0.5405	1.486	0.997	3
781	800	781_K	800_Q	0.5401	1.485	0.997	19
623	626	623_K	626_S	0.5397	1.484	0.997	3
788	796	788_Y	796_A	0.5393	1.483	0.997	8
524	527	524_S	527_H	0.5374	1.478	0.997	3
607	616	607_V	616_Q	0.534	1.468	0.997	9
788	793	788_Y	793_N	0.5332	1.466	0.997	5
716	735	716_A	735_L	0.533	1.466	0.997	19
443	451	443_T	451_D	0.5317	1.462	0.997	8
754	762	754_A	762_S	0.5316	1.462	0.997	8
719	727	719_D	727_E	0.5314	1.461	0.997	8
509	514	509_Y	514_N	0.5294	1.456	0.996	5
235	254	235_D	254_L	0.5288	1.454	0.996	19
258	270	258_N	270_M	0.5285	1.453	0.996	12
272	287	272_Q	287_S	0.5277	1.451	0.996	15
692	695	692_L	695_Q	0.5273	1.45	0.996	3
699	703	699_E	703_V	0.5272	1.45	0.996	4
517	520	517_L	520_K	0.527	1.449	0.996	3
453	457	453_G	457_N	0.526	1.446	0.996	4
483	486	483_L	486_Q	0.5258	1.446	0.996	3
439	443	439_K	443_T	0.5251	1.444	0.996	4
393	397	393_D	397_I	0.5237	1.44	0.996	4
163	166	163_Q	166_K	0.5233	1.439	0.996	3
214	233	214_A	233_Y	0.5212	1.433	0.996	19
258	263	258_N	263_Y	0.5212	1.433	0.996	5
291	296	291_Y	296_F	0.5205	1.431	0.996	5
229	232	229_K	232_Y	0.5195	1.429	0.996	3
291	299	291_Y	299_K	0.5194	1.428	0.996	8
401	405	401_Q	405_S	0.5191	1.427	0.996	4
699	702	699_E	702_N	0.5153	1.417	0.995	3
399	402	399_V	402_N	0.5151	1.416	0.995	3
785	801	785_G	801_Y	0.5142	1.414	0.995	16
443	448	443_T	448_D	0.5129	1.41	0.995	5
600	620	600_S	620_K	0.5121	1.408	0.995	20
217	233	217_A	233_Y	0.512	1.408	0.995	16
436	455	436_Y	455_Y	0.5115	1.406	0.995	19
405	439	405_S	439_K	0.5102	1.403	0.995	34
254	270	254_L	270_M	0.5097	1.402	0.995	16
439	455	439_K	455_Y	0.5084	1.398	0.995	16
305	316	305_N	316_L	0.5081	1.397	0.995	11
314	346	314_L	346_S	0.5078	1.396	0.995	32
333	349	333_L	349_A	0.5031	1.383	0.994	16
713	749	713_Q	749_L	0.5021	1.381	0.994	36
469	504	469_I	504_N	0.5015	1.379	0.994	35
796	799	796_A	799_S	0.5007	1.377	0.994	3
362	365	362_D	365_A	0.5	1.375	0.994	3
354	359	354_D	359_N	0.4977	1.368	0.993	5
698	715	698_K	715_L	0.495	1.361	0.993	17
168	182	168_Y	182_N	0.4926	1.354	0.993	14
197	201	197_F	201_K	0.4921	1.353	0.993	4
195	198	195_E	198_E	0.4904	1.349	0.993	3
475	487	475_Y	487_E	0.4896	1.346	0.992	12
750	754	750_A	754_A	0.4893	1.346	0.992	4
697	714	697_I	714_T	0.4852	1.334	0.992	17
368	386	368_Q	386_I	0.4842	1.331	0.992	18
485	508	485_N	508_T	0.4818	1.325	0.991	23
354	362	354_D	362_D	0.4811	1.323	0.991	8
287	303	287_S	303_Q	0.4808	1.322	0.991	16
221	229	221_A	229_K	0.4803	1.321	0.991	8
181	213	181_Y	213_A	0.4776	1.313	0.99	32
351	370	351_T	370_S	0.4759	1.309	0.99	19
266	269	266_E	269_Q	0.4723	1.299	0.989	3
784	800	784_L	800_Q	0.4714	1.296	0.989	16
320	328	320_Y	328_K	0.4708	1.295	0.989	8
732	749	732_Y	749_L	0.4703	1.293	0.989	17
505	509	505_L	509_Y	0.4692	1.29	0.989	4
258	266	258_N	266_E	0.4691	1.29	0.989	8
469	501	469_I	501_L	0.4674	1.285	0.988	32
488	504	488_F	504_N	0.4655	1.28	0.988	16
148	167	148_M	167_V	0.4652	1.279	0.988	19
320	325	320_Y	325_E	0.4651	1.279	0.988	5
607	620	607_V	620_K	0.4629	1.273	0.987	13
187	199	187_Q	199_S	0.4612	1.268	0.987	12
155	163	155_L	163_Q	0.4609	1.267	0.987	8
733	750	733_N	750_A	0.4608	1.267	0.987	17
335	338	335_T	338_K	0.4601	1.265	0.987	3
202	205	202_K	205_A	0.4593	1.263	0.987	3
291	303	291_Y	303_Q	0.458	1.259	0.986	12
170	173	170_Q	173_V	0.4579	1.259	0.986	3
344	370	344_N	370_S	0.4578	1.259	0.986	26
271	286	271_L	286_L	0.4546	1.25	0.985	15
769	772	769_L	772_L	0.454	1.248	0.985	3
658	689	658_H	689_L	0.4519	1.243	0.985	31
784	788	784_L	788_Y	0.4508	1.24	0.984	4
330	353	330_K	353_V	0.4491	1.235	0.984	23
655	697	655_A	697_I	0.4469	1.229	0.983	42
704	707	704_S	707_K	0.4452	1.224	0.983	3
751	770	751_A	770_S	0.4441	1.221	0.982	19
320	332	320_Y	332_A	0.4439	1.22	0.982	12
490	494	490_K	494_D	0.4425	1.217	0.982	4
524	528	524_S	528_L	0.4425	1.217	0.982	4
603	607	603_F	607_V	0.442	1.215	0.981	4
197	220	197_F	220_C	0.4413	1.213	0.981	23
453	471	453_G	471_N	0.4407	1.212	0.981	18
252	282	252_Y	282_V	0.4396	1.209	0.981	30
698	702	698_K	702_N	0.4381	1.205	0.98	4
215	250	215_I	250_Y	0.4371	1.202	0.98	35
729	750	729_Y	750_A	0.4334	1.192	0.978	21
386	403	386_I	403_S	0.4329	1.19	0.978	17
798	802	798_I	802_K	0.4324	1.189	0.978	4
733	737	733_N	737_D	0.4323	1.189	0.978	4
155	160	155_L	160_E	0.4305	1.184	0.977	5
149	179	149_I	179_S	0.4304	1.184	0.977	30
506	525	506_A	525_S	0.4299	1.182	0.977	19
151	167	151_K	167_V	0.4294	1.181	0.977	16
234	253	234_I	253_Y	0.4285	1.178	0.976	19
317	336	317_G	336_A	0.4283	1.178	0.976	19
635	696	635_N	696_K	0.4245	1.167	0.974	61
197	224	197_F	224_L	0.4224	1.162	0.974	27
364	390	364_L	390_L	0.4214	1.159	0.973	26
201	205	201_K	205_A	0.4213	1.158	0.973	4
509	521	509_Y	521_H	0.4209	1.157	0.973	12
765	769	765_A	769_L	0.4208	1.157	0.973	4
218	230	218_A	230_F	0.4195	1.153	0.972	12
387	407	387_Q	407_D	0.4188	1.152	0.972	20
482	512	482_R	512_M	0.4186	1.151	0.972	30
437	470	437_I	470_A	0.4172	1.147	0.971	33
390	396	390_L	396_N	0.4167	1.146	0.971	6
392	396	392_K	396_N	0.4165	1.145	0.97	4
754	766	754_A	766_L	0.4159	1.144	0.97	12
347	370	347_L	370_S	0.4154	1.142	0.97	23
770	780	770_S	780_S	0.4153	1.142	0.97	10
713	746	713_Q	746_T	0.4151	1.141	0.97	33
330	350	330_K	350_L	0.415	1.141	0.97	20
330	354	330_K	354_D	0.4148	1.141	0.97	24
523	527	523_S	527_H	0.4137	1.138	0.969	4
774	777	774_D	777_N	0.4136	1.137	0.969	3
694	715	694_R	715_L	0.4134	1.137	0.969	21
523	603	523_S	603_F	0.4127	1.135	0.968	80
390	399	390_L	399_V	0.4126	1.135	0.968	9
155	167	155_L	167_V	0.4104	1.128	0.967	12
318	322	318_L	322_R	0.4099	1.127	0.967	4
764	787	764_I	787_L	0.4091	1.125	0.966	23
390	403	390_L	403_S	0.4082	1.122	0.965	13
700	711	700_L	711_I	0.4076	1.121	0.965	11
785	804	785_G	804_L	0.4073	1.12	0.965	19
607	613	607_V	613_L	0.4073	1.12	0.965	6
789	801	789_Q	801_Y	0.4067	1.118	0.965	12
268	287	268_L	287_S	0.4065	1.118	0.965	19
730	734	730_A	734_S	0.4059	1.116	0.964	4
364	389	364_L	389_R	0.4059	1.116	0.964	25
769	773	769_L	773_T	0.4056	1.115	0.964	4
156	168	156_Y	168_Y	0.4049	1.113	0.963	12
495	498	495_Y	498_H	0.4042	1.111	0.963	3
386	390	386_I	390_L	0.4031	1.108	0.962	4
369	372	369_N	372_D	0.403	1.108	0.962	3
221	233	221_A	233_Y	0.4006	1.102	0.961	12
184	203	184_G	203_A	0.4002	1.1	0.96	19
330	357	330_K	357_T	0.4002	1.1	0.96	27
200	216	200_F	216_N	0.3997	1.099	0.96	16
255	274	255_S	274_T	0.3994	1.098	0.96	19
744	770	744_T	770_S	0.3991	1.097	0.959	26
165	187	165_L	187_Q	0.3979	1.094	0.958	22
729	757	729_Y	757_A	0.3972	1.092	0.958	28
236	239	236_L	239_V	0.3968	1.091	0.958	3
314	349	314_L	349_A	0.3967	1.091	0.958	35
364	386	364_L	386_I	0.3965	1.09	0.957	22
288	300	288_A	300_A	0.3962	1.089	0.957	12
768	784	768_Q	784_L	0.3944	1.085	0.956	16
329	353	329_A	353_V	0.3943	1.084	0.956	24
490	493	490_K	493_K	0.3937	1.082	0.955	3
601	634	601_L	634_A	0.3937	1.082	0.955	33
726	757	726_E	757_A	0.3935	1.082	0.955	31
288	307	288_A	307_Q	0.3933	1.082	0.955	19
485	509	485_N	509_Y	0.3927	1.08	0.954	24
152	171	152_A	171_V	0.3907	1.074	0.953	19
406	410	406_K	410_K	0.3906	1.074	0.953	4
443	455	443_T	455_Y	0.3904	1.074	0.953	12
481	508	481_L	508_T	0.3895	1.071	0.952	27
694	718	694_R	718_L	0.3892	1.07	0.951	24
785	800	785_G	800_Q	0.3891	1.07	0.951	15
719	731	719_D	731_L	0.3886	1.068	0.951	12
720	753	720_I	753_A	0.3884	1.068	0.951	33
532	535	532_N	535_A	0.3878	1.066	0.95	3
622	626	622_A	626_S	0.3878	1.066	0.95	4
489	493	489_Q	493_K	0.3868	1.064	0.949	4
180	203	180_N	203_A	0.3867	1.063	0.949	23
171	179	171_V	179_S	0.3864	1.062	0.949	8
733	762	733_N	762_S	0.3856	1.06	0.948	29
507	511	507_L	511_Q	0.3854	1.06	0.948	4
202	206	202_K	206_N	0.3854	1.06	0.948	4
468	490	468_K	490_K	0.3852	1.059	0.948	22
145	171	145_I	171_V	0.385	1.059	0.948	26
166	170	166_K	170_Q	0.3844	1.057	0.947	4
367	385	367_L	385_K	0.3826	1.052	0.945	18
283	303	283_A	303_Q	0.3819	1.05	0.945	20
458	461	458_T	461_A	0.3818	1.05	0.945	3
177	203	177_S	203_A	0.3816	1.049	0.944	26
197	217	197_F	217_A	0.381	1.048	0.944	20
694	722	694_R	722_A	0.3807	1.047	0.943	28
472	491	472_I	491_L	0.3799	1.045	0.943	19
231	254	231_R	254_L	0.3782	1.04	0.941	23
716	731	716_A	731_L	0.3782	1.04	0.941	15
748	783	748_F	783_A	0.3781	1.04	0.941	35
691	722	691_N	722_A	0.3753	1.032	0.938	31
698	727	698_K	727_E	0.3751	1.031	0.937	29
186	190	186_S	190_E	0.375	1.031	0.937	4
154	158	154_A	158_K	0.3747	1.03	0.937	4
165	183	165_L	183_L	0.3746	1.03	0.937	18
343	346	343_F	346_S	0.3742	1.029	0.937	3
219	223	219_V	223_K	0.3738	1.028	0.936	4
444	456	444_D	456_L	0.3735	1.027	0.936	12
336	346	336_A	346_S	0.3729	1.025	0.935	10
188	200	188_M	200_F	0.3726	1.025	0.935	12
301	316	301_I	316_L	0.3724	1.024	0.934	15
305	328	305_N	328_K	0.3713	1.021	0.933	23
319	323	319_L	323_I	0.371	1.02	0.933	4
506	518	506_A	518_A	0.3708	1.019	0.932	12
730	733	730_A	733_N	0.3705	1.019	0.932	3
709	735	709_E	735_L	0.37	1.017	0.931	26
638	658	638_Y	658_H	0.3696	1.016	0.931	20
485	505	485_N	505_L	0.369	1.015	0.931	20
638	696	638_Y	696_K	0.3686	1.013	0.93	58
170	174	170_Q	174_Y	0.3675	1.011	0.929	4
454	458	454_V	458_T	0.3672	1.01	0.928	4
198	202	198_E	202_K	0.3668	1.009	0.928	4
406	409	406_K	409_L	0.3667	1.008	0.927	3
658	692	658_H	692_L	0.3665	1.008	0.927	34
259	290	259_Y	290_I	0.3658	1.006	0.926	31
485	512	485_N	512_M	0.3648	1.003	0.925	27
369	373	369_N	373_N	0.3646	1.003	0.925	4
472	484	472_I	484_A	0.3646	1.002	0.925	12
736	746	736_I	746_T	0.364	1.001	0.924	10
265	294	265_P	294_M	0.3638	1	0.924	29
491	501	491_L	501_L	0.3627	0.997	0.922	10
301	319	301_I	319_L	0.3624	0.997	0.922	18
384	438	384_Y	438_K	0.3624	0.996	0.922	54
218	237	218_A	237_A	0.3623	0.996	0.922	19
755	767	755_I	767_L	0.362	0.995	0.921	12
486	490	486_Q	490_K	0.3617	0.995	0.921	4
268	291	268_L	291_Y	0.3616	0.994	0.921	23
207	210	207_G	210_Q	0.3616	0.994	0.921	3
327	357	327_A	357_T	0.3615	0.994	0.921	30
453	475	453_G	475_Y	0.3612	0.993	0.92	22
473	477	473_I	477_L	0.3601	0.99	0.919	4
203	213	203_A	213_A	0.36	0.99	0.919	10
735	746	735_L	746_T	0.36	0.99	0.919	11
441	445	441_N	445_F	0.3595	0.988	0.918	4
348	385	348_A	385_K	0.3593	0.988	0.918	37
740	743	740_G	743_D	0.3593	0.988	0.918	3
352	356	352_L	356_K	0.3589	0.987	0.917	4
184	196	184_G	196_A	0.3588	0.987	0.917	12
304	315	304_L	315_S	0.3583	0.985	0.916	11
516	520	516_E	520_K	0.357	0.982	0.914	4
235	239	235_D	239_V	0.3569	0.981	0.914	4
502	524	502_H	524_S	0.3565	0.98	0.913	22
259	271	259_Y	271_L	0.3555	0.978	0.912	12
529	532	529_N	532_N	0.3549	0.976	0.911	3
747	769	747_L	769_L	0.3545	0.975	0.911	22
622	638	622_A	638_Y	0.3544	0.975	0.911	16
764	784	764_I	784_L	0.3543	0.974	0.91	20
717	749	717_Y	749_L	0.3538	0.973	0.909	32
456	470	456_L	470_A	0.3535	0.972	0.909	14
458	462	458_T	462_L	0.3533	0.972	0.909	4
694	719	694_R	719_D	0.3528	0.97	0.908	25
453	478	453_G	478_N	0.3525	0.969	0.907	25
317	329	317_G	329_A	0.3513	0.966	0.905	12
302	306	302_Q	306_S	0.3508	0.965	0.905	4
440	459	440_A	459_S	0.3497	0.962	0.903	19
252	286	252_Y	286_L	0.3493	0.961	0.902	34
636	711	636_I	711_I	0.3485	0.958	0.901	75
747	770	747_L	770_S	0.3481	0.957	0.9	23
604	624	604_E	624_L	0.348	0.957	0.9	20
353	357	353_V	357_T	0.3479	0.957	0.9	4
248	274	248_K	274_T	0.3477	0.956	0.899	26
366	369	366_R	369_N	0.3471	0.954	0.898	3
194	224	194_Q	224_L	0.3469	0.954	0.898	30
230	234	230_F	234_I	0.3469	0.954	0.898	4
743	746	743_D	746_T	0.3468	0.954	0.898	3
165	190	165_L	190_E	0.3466	0.953	0.897	25
777	780	777_N	780_S	0.3466	0.953	0.897	3
368	372	368_Q	372_D	0.3463	0.952	0.897	4
162	190	162_E	190_E	0.3454	0.95	0.896	28
310	336	310_F	336_A	0.3454	0.95	0.896	26
499	525	499_S	525_S	0.3454	0.95	0.896	26
695	699	695_Q	699_E	0.3448	0.948	0.894	4
185	189	185_V	189_N	0.3446	0.947	0.894	4
518	522	518_A	522_F	0.3441	0.946	0.893	4
700	703	700_L	703_V	0.3438	0.945	0.892	3
383	406	383_A	406_K	0.3431	0.943	0.891	23
503	602	503_Y	602_I	0.3414	0.939	0.888	99
405	409	405_S	409_L	0.3411	0.938	0.888	4
714	717	714_T	717_Y	0.3407	0.937	0.887	3
280	307	280_S	307_Q	0.3405	0.936	0.886	27
252	256	252_Y	256_L	0.3403	0.936	0.886	4
384	435	384_Y	435_L	0.34	0.935	0.886	51
506	521	506_A	521_H	0.3397	0.934	0.885	15
307	312	307_Q	312_S	0.3386	0.931	0.883	5
622	692	622_A	692_L	0.3384	0.93	0.882	70
196	200	196_A	200_F	0.3374	0.928	0.881	4
214	236	214_A	236_L	0.3373	0.927	0.88	22
729	754	729_Y	754_A	0.336	0.924	0.878	25
337	346	337_M	346_S	0.3359	0.924	0.878	9
255	270	255_S	270_M	0.3341	0.919	0.874	15
452	456	452_A	456_L	0.3335	0.917	0.872	4
211	237	211_S	237_A	0.3332	0.916	0.872	26
707	711	707_K	711_I	0.3331	0.916	0.872	4
165	186	165_L	186_S	0.3327	0.915	0.871	21
215	253	215_I	253_Y	0.3323	0.914	0.87	38
502	525	502_H	525_S	0.3322	0.913	0.869	23
317	332	317_G	332_A	0.3316	0.912	0.869	15
347	369	347_L	369_N	0.3316	0.912	0.869	22
334	338	334_S	338_K	0.3311	0.91	0.867	4
401	443	401_Q	443_T	0.3302	0.908	0.865	42
450	478	450_A	478_N	0.3301	0.908	0.865	28
292	297	292_A	297_D	0.3299	0.907	0.865	5
184	199	184_G	199_S	0.3296	0.906	0.864	15
712	734	712_L	734_S	0.3282	0.903	0.861	22
751	766	751_A	766_L	0.3279	0.902	0.86	15
498	501	498_H	501_L	0.3277	0.901	0.86	3
476	508	476_A	508_T	0.3273	0.9	0.859	32
482	486	482_R	486_Q	0.3272	0.9	0.859	4
301	323	301_I	323_I	0.3268	0.899	0.858	22
752	756	752_V	756_G	0.3267	0.898	0.857	4
605	621	605_A	621_I	0.3267	0.898	0.857	16
161	186	161_V	186_S	0.3266	0.898	0.857	25
231	261	231_R	261_K	0.3265	0.898	0.857	30
449	474	449_S	474_N	0.3263	0.897	0.856	25
624	634	624_L	634_A	0.3254	0.895	0.855	10
604	620	604_E	620_K	0.3251	0.894	0.854	16
631	634	631_D	634_A	0.3249	0.893	0.853	3
601	637	601_L	637_L	0.3249	0.893	0.853	36
256	260	256_L	260_Y	0.3247	0.893	0.853	4
615	618	615_N	618_D	0.3245	0.892	0.852	3
364	392	364_L	392_K	0.3244	0.892	0.852	28
712	735	712_L	735_L	0.3242	0.892	0.852	23
335	339	335_T	339_I	0.3237	0.89	0.85	4
329	333	329_A	333_L	0.3236	0.89	0.85	4
351	366	351_T	366_R	0.3235	0.889	0.849	15
799	803	799_S	803_T	0.3229	0.888	0.849	4
746	749	746_T	749_L	0.3228	0.888	0.849	3
374	379	374_D	379_K	0.3227	0.887	0.848	5
379	382	379_K	382_D	0.3221	0.886	0.847	3
167	170	167_V	170_Q	0.3216	0.884	0.845	3
318	349	318_L	349_A	0.3216	0.884	0.845	31
436	459	436_Y	459_S	0.3214	0.884	0.845	23
767	783	767_L	783_A	0.3214	0.884	0.845	16
181	185	181_Y	185_V	0.3211	0.883	0.844	4
766	770	766_L	770_S	0.3206	0.882	0.843	4
334	362	334_S	362_D	0.3205	0.881	0.842	28
300	304	300_A	304_L	0.3201	0.88	0.841	4
164	168	164_A	168_Y	0.3198	0.879	0.84	4
355	389	355_I	389_R	0.3197	0.879	0.84	34
321	333	321_A	333_L	0.3196	0.879	0.84	12
167	171	167_V	171_V	0.3194	0.878	0.839	4
153	157	153_N	157_L	0.3192	0.878	0.839	4
491	494	491_L	494_D	0.3191	0.877	0.839	3
473	504	473_I	504_N	0.3179	0.874	0.836	31
800	803	800_Q	803_T	0.3178	0.874	0.836	3
301	320	301_I	320_Y	0.3177	0.874	0.836	19
617	621	617_V	621_I	0.3175	0.873	0.835	4
619	623	619_V	623_K	0.3174	0.873	0.835	4
510	522	510_A	522_F	0.3174	0.873	0.835	12
752	767	752_V	767_L	0.3171	0.872	0.834	15
156	186	156_Y	186_S	0.3154	0.867	0.829	30
361	365	361_Q	365_A	0.3146	0.865	0.827	4
764	788	764_I	788_Y	0.3146	0.865	0.827	24
363	367	363_M	367_L	0.3142	0.864	0.826	4
259	264	259_Y	264_Y	0.3135	0.862	0.824	5
220	224	220_C	224_L	0.3134	0.862	0.824	4
619	622	619_V	622_A	0.3131	0.861	0.823	3
655	700	655_A	700_L	0.313	0.861	0.823	45
725	753	725_Y	753_A	0.3121	0.858	0.82	28
450	454	450_A	454_V	0.312	0.858	0.82	4
468	491	468_K	491_L	0.312	0.858	0.82	23
788	800	788_Y	800_Q	0.3114	0.856	0.818	12
403	406	403_S	406_K	0.3113	0.856	0.818	3
230	257	230_F	257_I	0.3109	0.855	0.817	27
199	203	199_S	203_A	0.3108	0.855	0.817	4
604	617	604_E	617_V	0.3106	0.854	0.816	13
148	170	148_M	170_Q	0.3106	0.854	0.816	22
326	357	326_Y	357_T	0.3102	0.853	0.815	31
298	323	298_S	323_I	0.3096	0.851	0.813	25
656	660	656_Q	660_K	0.3096	0.851	0.813	4
763	767	763_A	767_L	0.3092	0.85	0.812	4
237	250	237_A	250_Y	0.3091	0.85	0.812	13
520	523	520_K	523_S	0.3088	0.849	0.811	3
753	757	753_A	757_A	0.3088	0.849	0.811	4
457	461	457_N	461_A	0.3087	0.849	0.811	4
731	735	731_L	735_L	0.3084	0.848	0.81	4
193	197	193_F	197_F	0.3084	0.848	0.81	4
748	780	748_F	780_S	0.308	0.847	0.809	32
152	167	152_A	167_V	0.3077	0.846	0.808	15
149	153	149_I	153_N	0.3075	0.846	0.808	4
624	627	624_L	627_E	0.3074	0.845	0.807	3
141	144	141_D	144_R	0.3073	0.845	0.807	3
636	714	636_I	714_T	0.3073	0.845	0.807	78
371	382	371_Y	382_D	0.3071	0.845	0.807	11
761	791	761_N	791_V	0.3071	0.844	0.805	30
786	790	786_M	790_E	0.3071	0.844	0.805	4
452	474	452_A	474_N	0.3069	0.844	0.805	22
463	466	463_S	466_N	0.3068	0.844	0.805	3
387	400	387_Q	400_A	0.3067	0.843	0.804	13
444	474	444_D	474_N	0.3065	0.843	0.804	30
696	699	696_K	699_E	0.3064	0.843	0.804	3
717	732	717_Y	732_Y	0.3062	0.842	0.803	15
257	261	257_I	261_K	0.3056	0.84	0.801	4
441	470	441_N	470_A	0.3055	0.84	0.801	29
193	220	193_F	220_C	0.3055	0.84	0.801	27
453	474	453_G	474_N	0.3049	0.838	0.799	21
289	293	289_K	293_K	0.3048	0.838	0.799	4
781	804	781_K	804_L	0.3047	0.838	0.799	23
279	282	279_Y	282_V	0.3045	0.837	0.798	3
236	240	236_L	240_Y	0.3043	0.837	0.798	4
768	772	768_Q	772_L	0.3042	0.836	0.797	4
492	502	492_I	502_H	0.3037	0.835	0.796	10
695	698	695_Q	698_K	0.3037	0.835	0.796	3
197	221	197_F	221_A	0.3035	0.834	0.795	24
270	274	270_M	274_T	0.3033	0.834	0.795	4
782	786	782_A	786_M	0.303	0.833	0.793	4
332	335	332_A	335_T	0.3023	0.831	0.791	3
351	363	351_T	363_M	0.3022	0.831	0.791	12
618	638	618_D	638_Y	0.3002	0.826	0.785	20
326	353	326_Y	353_V	0.3001	0.825	0.784	27
370	382	370_S	382_D	0.3001	0.825	0.784	12
285	315	285_Y	315_S	0.3	0.825	0.784	30
397	442	397_I	442_V	0.2997	0.824	0.783	45
300	319	300_A	319_L	0.2996	0.824	0.783	19
268	294	268_L	294_M	0.2995	0.824	0.783	26
290	294	290_I	294_M	0.2995	0.824	0.783	4
214	237	214_A	237_A	0.2995	0.824	0.783	23
251	274	251_D	274_T	0.2992	0.823	0.782	23
440	452	440_A	452_A	0.2992	0.823	0.782	12
521	524	521_H	524_S	0.298	0.819	0.777	3
256	271	256_L	271_L	0.2979	0.819	0.777	15
623	627	623_K	627_E	0.2979	0.819	0.777	4
748	752	748_F	752_V	0.2978	0.819	0.777	4
313	335	313_S	335_T	0.2976	0.818	0.776	22
169	173	169_E	173_V	0.2973	0.818	0.776	4
268	290	268_L	290_I	0.2971	0.817	0.775	22
736	747	736_I	747_L	0.297	0.817	0.775	11
438	441	438_K	441_N	0.2967	0.816	0.774	3
255	267	255_S	267_A	0.2965	0.815	0.772	12
525	535	525_S	535_A	0.296	0.814	0.771	10
366	370	366_R	370_S	0.2955	0.813	0.77	4
371	383	371_Y	383_A	0.2954	0.812	0.769	12
401	442	401_Q	442_V	0.2953	0.812	0.769	41
233	236	233_Y	236_L	0.295	0.811	0.768	3
313	336	313_S	336_A	0.2949	0.811	0.768	23
172	179	172_A	179_S	0.2943	0.809	0.765	7
778	804	778_K	804_L	0.294	0.808	0.764	26
166	169	166_K	169_E	0.2938	0.808	0.764	3
264	290	264_Y	290_I	0.2937	0.808	0.764	26
314	343	314_L	343_F	0.2933	0.806	0.761	29
718	722	718_L	722_A	0.2929	0.805	0.76	4
222	234	222_L	234_I	0.2926	0.805	0.76	12
337	347	337_M	347_L	0.2921	0.803	0.758	10
615	619	615_N	619_V	0.2912	0.801	0.755	4
459	462	459_S	462_L	0.2912	0.801	0.755	3
606	611	606_I	611_N	0.2912	0.801	0.755	5
309	312	309_N	312_S	0.2912	0.801	0.755	3
228	261	228_E	261_K	0.2908	0.8	0.754	33
618	657	618_D	657_I	0.2902	0.798	0.751	39
755	760	755_I	760_P	0.2898	0.797	0.75	5
303	307	303_Q	307_Q	0.2897	0.797	0.75	4
520	524	520_K	524_S	0.2894	0.796	0.749	4
457	483	457_N	483_L	0.2893	0.795	0.747	26
241	244	241_L	244_E	0.2891	0.795	0.747	3
265	269	265_P	269_Q	0.2891	0.795	0.747	4
144	147	144_R	147_G	0.2891	0.795	0.747	3
292	319	292_A	319_L	0.2891	0.795	0.747	27
148	171	148_M	171_V	0.2885	0.793	0.745	23
259	286	259_Y	286_L	0.2884	0.793	0.745	27
270	273	270_M	273_R	0.2883	0.793	0.745	3
472	487	472_I	487_E	0.2876	0.791	0.742	15
314	318	314_L	318_L	0.2875	0.79	0.741	4
628	631	628_L	631_D	0.2872	0.79	0.741	3
398	402	398_A	402_N	0.287	0.789	0.739	4
400	404	400_A	404_F	0.2867	0.788	0.738	4
436	458	436_Y	458_T	0.2864	0.788	0.738	22
786	801	786_M	801_Y	0.2862	0.787	0.737	15
177	180	177_S	180_N	0.2861	0.787	0.737	3
713	717	713_Q	717_Y	0.2858	0.786	0.735	4
720	732	720_I	732_Y	0.2851	0.784	0.733	12
716	728	716_A	728_A	0.285	0.784	0.733	12
492	501	492_I	501_L	0.2849	0.784	0.733	9
292	304	292_A	304_L	0.2848	0.783	0.731	12
156	161	156_Y	161_V	0.2848	0.783	0.731	5
303	306	303_Q	306_S	0.2847	0.783	0.731	3
185	200	185_V	200_F	0.2847	0.783	0.731	15
402	406	402_N	406_K	0.2839	0.781	0.729	4
728	732	728_A	732_Y	0.283	0.778	0.725	4
198	201	198_E	201_K	0.283	0.778	0.725	3
297	323	297_D	323_I	0.2829	0.778	0.725	26
701	711	701_I	711_I	0.2821	0.776	0.722	10
601	605	601_L	605_A	0.2819	0.775	0.721	4
782	785	782_A	785_G	0.2816	0.774	0.719	3
751	763	751_A	763_A	0.2812	0.773	0.718	12
232	236	232_Y	236_L	0.2805	0.771	0.715	4
181	216	181_Y	216_N	0.2804	0.771	0.715	35
402	405	402_N	405_S	0.2803	0.771	0.715	3
440	455	440_A	455_Y	0.2796	0.769	0.712	15
331	335	331_V	335_T	0.2792	0.768	0.711	4
383	407	383_A	407_D	0.279	0.767	0.709	24
525	528	525_S	528_L	0.2789	0.767	0.709	3
618	687	618_D	687_A	0.2789	0.767	0.709	69
196	220	196_A	220_C	0.2787	0.766	0.708	24
768	771	768_Q	771_K	0.2787	0.766	0.708	3
269	273	269_Q	273_R	0.2784	0.765	0.706	4
765	768	765_A	768_Q	0.2782	0.765	0.706	3
717	721	717_Y	721_F	0.2776	0.763	0.704	4
172	180	172_A	180_N	0.2774	0.763	0.704	8
620	623	620_K	623_K	0.2772	0.762	0.702	3
231	258	231_R	258_N	0.2772	0.762	0.702	27
771	781	771_K	781_K	0.2767	0.761	0.701	10
370	373	370_S	373_N	0.2767	0.761	0.701	3
549	552	549_D	552_K	0.2766	0.76	0.699	3
180	202	180_N	202_K	0.2763	0.76	0.699	22
787	791	787_L	791_V	0.2763	0.76	0.699	4
771	780	771_K	780_S	0.276	0.759	0.698	9
231	257	231_R	257_I	0.2752	0.757	0.695	26
749	752	749_L	752_V	0.2751	0.756	0.694	3
729	759	729_Y	759_N	0.275	0.756	0.694	30
487	490	487_E	490_K	0.2749	0.756	0.694	3
234	238	234_I	238_Q	0.2747	0.755	0.692	4
789	794	789_Q	794_Y	0.2745	0.755	0.692	5
340	343	340_E	343_F	0.2745	0.755	0.692	3
182	185	182_N	185_V	0.274	0.753	0.689	3
709	743	709_E	743_D	0.274	0.753	0.689	34
199	202	199_S	202_K	0.2737	0.753	0.689	3
149	152	149_I	152_A	0.2734	0.752	0.688	3
216	219	216_N	219_V	0.2732	0.751	0.686	3
338	372	338_K	372_D	0.273	0.751	0.686	34
204	214	204_I	214_A	0.2727	0.75	0.685	10
734	739	734_S	739_Y	0.2727	0.75	0.685	5
614	657	614_N	657_I	0.2726	0.749	0.683	43
321	353	321_A	353_V	0.2724	0.749	0.683	32
800	804	800_Q	804_L	0.2723	0.749	0.683	4
469	473	469_I	473_I	0.2721	0.748	0.682	4
264	294	264_Y	294_M	0.2719	0.748	0.682	30
727	731	727_E	731_L	0.2713	0.746	0.679	4
355	367	355_I	367_L	0.2712	0.746	0.679	12
761	764	761_N	764_I	0.2711	0.745	0.677	3
385	388	385_K	388_V	0.271	0.745	0.677	3
269	272	269_Q	272_Q	0.2708	0.745	0.677	3
404	438	404_F	438_K	0.2707	0.744	0.676	34
400	442	400_A	442_V	0.2706	0.744	0.676	42
251	273	251_D	273_R	0.2706	0.744	0.676	22
507	522	507_L	522_F	0.2705	0.744	0.676	15
789	797	789_Q	797_A	0.2701	0.743	0.674	8
503	507	503_Y	507_L	0.2699	0.742	0.673	4
720	725	720_I	725_Y	0.2697	0.742	0.673	5
433	459	433_A	459_S	0.2697	0.741	0.671	26
766	769	766_L	769_L	0.2694	0.741	0.671	3
508	512	508_T	512_M	0.2691	0.74	0.67	4
489	517	489_Q	517_L	0.2689	0.74	0.67	28
731	734	731_L	734_S	0.2689	0.739	0.668	3
153	168	153_N	168_Y	0.2687	0.739	0.668	15
147	150	147_G	150_Q	0.2681	0.737	0.665	3
694	724	694_R	724_Q	0.2678	0.736	0.664	30
380	407	380_I	407_D	0.2667	0.733	0.659	27
762	766	762_S	766_L	0.2667	0.733	0.659	4
720	749	720_I	749_L	0.2666	0.733	0.659	29
176	179	176_E	179_S	0.2661	0.732	0.657	3
315	318	315_S	318_L	0.2661	0.732	0.657	3
252	255	252_Y	255_S	0.2659	0.731	0.656	3
348	370	348_A	370_S	0.2655	0.73	0.654	22
476	481	476_A	481_L	0.2638	0.725	0.647	5
218	233	218_A	233_Y	0.2637	0.725	0.647	15
522	526	522_F	526_Y	0.2636	0.725	0.647	4
384	388	384_Y	388_V	0.2623	0.721	0.64	4
188	193	188_M	193_F	0.2621	0.721	0.64	5
605	610	605_A	610_N	0.2621	0.721	0.64	5
752	783	752_V	783_A	0.2618	0.72	0.639	31
398	446	398_A	446_V	0.2617	0.72	0.639	48
655	693	655_A	693_E	0.2616	0.719	0.637	38
484	488	484_A	488_F	0.2614	0.719	0.637	4
333	337	333_L	337_M	0.2613	0.718	0.635	4
519	606	519_Y	606_I	0.2611	0.718	0.635	87
388	391	388_V	391_N	0.261	0.718	0.635	3
600	623	600_S	623_K	0.2608	0.717	0.634	23
781	803	781_K	803_T	0.2606	0.717	0.634	22
155	158	155_L	158_K	0.26	0.715	0.631	3
785	797	785_G	797_A	0.2596	0.714	0.629	12
283	306	283_A	306_S	0.2595	0.714	0.629	23
449	453	449_S	453_G	0.2595	0.713	0.627	4
522	602	522_F	602_I	0.2594	0.713	0.627	80
251	255	251_D	255_S	0.2593	0.713	0.627	4
432	435	432_Q	435_L	0.2591	0.712	0.626	3
483	487	483_L	487_E	0.2586	0.711	0.624	4
486	489	486_Q	489_Q	0.2581	0.71	0.623	3
222	253	222_L	253_Y	0.258	0.709	0.621	31
450	453	450_A	453_G	0.2579	0.709	0.621	3
401	439	401_Q	439_K	0.2577	0.709	0.621	38
476	488	476_A	488_F	0.257	0.707	0.618	12
527	626	527_H	626_S	0.2569	0.706	0.616	99
332	336	332_A	336_A	0.2566	0.706	0.616	4
437	441	437_I	441_N	0.2566	0.706	0.616	4
368	399	368_Q	399_V	0.2564	0.705	0.615	31
219	234	219_V	234_I	0.2564	0.705	0.615	15
149	176	149_I	176_E	0.2562	0.704	0.613	27
252	279	252_Y	279_Y	0.2557	0.703	0.611	27
691	695	691_N	695_Q	0.2556	0.703	0.611	4
616	620	616_Q	620_K	0.2555	0.703	0.611	4
476	504	476_A	504_N	0.2552	0.702	0.61	28
615	687	615_N	687_A	0.2551	0.701	0.608	72
347	373	347_L	373_N	0.2549	0.701	0.608	26
148	174	148_M	174_Y	0.2548	0.701	0.608	26
232	235	232_Y	235_D	0.2548	0.701	0.608	3
690	722	690_L	722_A	0.2544	0.699	0.605	32
618	689	618_D	689_L	0.2543	0.699	0.605	71
717	752	717_Y	752_V	0.254	0.698	0.603	35
468	494	468_K	494_D	0.2539	0.698	0.603	26
321	326	321_A	326_Y	0.2537	0.698	0.603	5
726	730	726_E	730_A	0.253	0.696	0.6	4
352	385	352_L	385_K	0.2525	0.694	0.596	33
283	307	283_A	307_Q	0.2522	0.694	0.596	24
764	791	764_I	791_V	0.2522	0.694	0.596	27
760	787	760_P	787_L	0.2517	0.692	0.593	27
540	544	540_M	544_K	0.2517	0.692	0.593	4
256	286	256_L	286_L	0.2511	0.69	0.59	30
327	331	327_A	331_V	0.2508	0.69	0.59	4
383	386	383_A	386_I	0.2508	0.69	0.59	3
348	352	348_A	352_L	0.2507	0.689	0.588	4
333	350	333_L	350_L	0.2507	0.689	0.588	17
161	190	161_V	190_E	0.2506	0.689	0.588	29
474	478	474_N	478_N	0.2506	0.689	0.588	4
625	635	625_R	635_N	0.2506	0.689	0.588	10
308	312	308_G	312_S	0.2503	0.688	0.587	4
297	319	297_D	319_L	0.2501	0.688	0.587	22
298	302	298_S	302_Q	0.2496	0.686	0.583	4
148	151	148_M	151_K	0.249	0.685	0.582	3
222	257	222_L	257_I	0.249	0.685	0.582	35
690	694	690_L	694_R	0.249	0.685	0.582	4
659	718	659_F	718_L	0.2487	0.684	0.58	59
781	785	781_K	785_G	0.2485	0.683	0.578	4
407	410	407_D	410_K	0.2483	0.683	0.578	3
371	386	371_Y	386_I	0.2481	0.682	0.576	15
455	458	455_Y	458_T	0.2478	0.681	0.575	3
634	637	634_A	637_L	0.2476	0.681	0.575	3
150	153	150_Q	153_N	0.2475	0.681	0.575	3
362	366	362_D	366_R	0.2473	0.68	0.573	4
797	801	797_A	801_Y	0.2473	0.68	0.573	4
211	215	211_S	215_I	0.247	0.679	0.571	4
748	751	748_F	751_A	0.2463	0.677	0.568	3
489	509	489_Q	509_Y	0.246	0.676	0.566	20
365	369	365_A	369_N	0.2458	0.676	0.566	4
210	213	210_Q	213_A	0.2455	0.675	0.565	3
488	492	488_F	492_I	0.2453	0.674	0.563	4
510	518	510_A	518_A	0.2452	0.674	0.563	8
194	198	194_Q	198_E	0.2451	0.674	0.563	4
355	363	355_I	363_M	0.2451	0.674	0.563	8
238	251	238_Q	251_D	0.2449	0.673	0.561	13
442	446	442_V	446_V	0.2449	0.673	0.561	4
215	219	215_I	219_V	0.2447	0.673	0.561	4
361	392	361_Q	392_K	0.2446	0.673	0.561	31
177	181	177_S	181_Y	0.244	0.671	0.558	4
360	389	360_Y	389_R	0.2439	0.671	0.558	29
492	505	492_I	505_L	0.2437	0.67	0.556	13
460	468	460_K	468_K	0.2435	0.67	0.556	8
621	637	621_I	637_L	0.2434	0.669	0.555	16
600	604	600_S	604_E	0.2434	0.669	0.555	4
308	313	308_G	313_S	0.2434	0.669	0.555	5
315	349	315_S	349_A	0.2433	0.669	0.555	34
292	315	292_A	315_S	0.2432	0.669	0.555	23
169	195	169_E	195_E	0.2426	0.667	0.551	26
469	491	469_I	491_L	0.2425	0.667	0.551	22
288	303	288_A	303_Q	0.2423	0.666	0.549	15
454	457	454_V	457_N	0.2421	0.666	0.549	3
285	289	285_Y	289_K	0.2417	0.665	0.548	4
318	333	318_L	333_L	0.2416	0.664	0.546	15
488	621	488_F	621_I	0.2416	0.664	0.546	133
153	182	153_N	182_N	0.2415	0.664	0.546	29
519	607	519_Y	607_V	0.2414	0.664	0.546	88
310	314	310_F	314_L	0.2414	0.664	0.546	4
204	213	204_I	213_A	0.2414	0.664	0.546	9
447	513	447_D	513_Q	0.2413	0.664	0.546	66
364	399	364_L	399_V	0.2413	0.664	0.546	35
286	289	286_L	289_K	0.2408	0.662	0.543	3
600	624	600_S	624_L	0.2407	0.662	0.543	24
711	714	711_I	714_T	0.2401	0.66	0.539	3
502	528	502_H	528_L	0.24	0.66	0.539	26
693	697	693_E	697_I	0.2397	0.659	0.538	4
188	196	188_M	196_A	0.2395	0.659	0.538	8
456	460	456_L	460_K	0.2395	0.658	0.536	4
608	621	608_A	621_I	0.239	0.657	0.534	13
368	457	368_Q	457_N	0.2384	0.656	0.532	89
387	403	387_Q	403_S	0.2382	0.655	0.531	16
444	470	444_D	470_A	0.238	0.654	0.529	26
449	477	449_S	477_L	0.2374	0.653	0.527	28
272	299	272_Q	299_K	0.2374	0.653	0.527	27
352	367	352_L	367_L	0.2374	0.653	0.527	15
228	232	228_E	232_Y	0.2372	0.652	0.526	4
227	257	227_K	257_I	0.2369	0.652	0.526	30
705	708	705_G	708_D	0.2369	0.651	0.524	3
363	389	363_M	389_R	0.2369	0.651	0.524	26
513	612	513_Q	612_N	0.2368	0.651	0.524	99
156	182	156_Y	182_N	0.2363	0.65	0.522	26
149	182	149_I	182_N	0.236	0.649	0.52	33
326	330	326_Y	330_K	0.2355	0.648	0.519	4
487	491	487_E	491_L	0.2351	0.647	0.517	4
473	488	473_I	488_F	0.2351	0.646	0.515	15
690	718	690_L	718_L	0.2347	0.645	0.514	28
264	268	264_Y	268_L	0.2345	0.645	0.514	4
331	334	331_V	334_S	0.2345	0.645	0.514	3
656	697	656_Q	697_I	0.2343	0.644	0.512	41
222	227	222_L	227_K	0.2342	0.644	0.512	5
237	240	237_A	240_Y	0.2341	0.644	0.512	3
238	241	238_Q	241_L	0.2339	0.643	0.51	3
760	791	760_P	791_V	0.2339	0.643	0.51	31
297	301	297_D	301_I	0.2337	0.643	0.51	4
755	763	755_I	763_A	0.2335	0.642	0.508	8
366	455	366_R	455_Y	0.2334	0.642	0.508	89
332	366	332_A	366_R	0.2331	0.641	0.507	34
618	658	618_D	658_H	0.2329	0.64	0.505	40
355	360	355_I	360_Y	0.2326	0.64	0.505	5
259	267	259_Y	267_A	0.2324	0.639	0.503	8
701	712	701_I	712_L	0.2322	0.638	0.502	11
767	771	767_L	771_K	0.2317	0.637	0.5	4
747	773	747_L	773_T	0.2313	0.636	0.498	26
713	735	713_Q	735_L	0.2311	0.636	0.498	22
172	183	172_A	183_L	0.231	0.635	0.496	11
150	154	150_Q	154_A	0.231	0.635	0.496	4
755	787	755_I	787_L	0.2301	0.633	0.493	32
516	519	516_E	519_Y	0.23	0.632	0.491	3
404	488	404_F	488_F	0.2297	0.632	0.491	84
783	786	783_A	786_M	0.2294	0.631	0.49	3
330	359	330_K	359_N	0.229	0.63	0.488	29
780	783	780_S	783_A	0.2286	0.629	0.486	3
253	256	253_Y	256_L	0.2285	0.628	0.484	3
168	179	168_Y	179_S	0.228	0.627	0.483	11
602	606	602_I	606_I	0.2278	0.626	0.481	4
519	603	519_Y	603_F	0.2275	0.626	0.481	84
274	282	274_T	282_V	0.2273	0.625	0.479	8
732	753	732_Y	753_A	0.227	0.624	0.478	21
383	410	383_A	410_K	0.2268	0.624	0.478	27
179	182	179_S	182_N	0.2266	0.623	0.476	3
768	796	768_Q	796_A	0.2264	0.623	0.476	28
321	356	321_A	356_K	0.2264	0.622	0.474	35
626	702	626_S	702_N	0.2263	0.622	0.474	76
403	407	403_S	407_D	0.226	0.621	0.472	4
455	459	455_Y	459_S	0.2259	0.621	0.472	4
292	300	292_A	300_A	0.2258	0.621	0.472	8
764	793	764_I	793_N	0.2258	0.621	0.472	29
321	349	321_A	349_A	0.2257	0.621	0.472	28
799	802	799_S	802_K	0.2257	0.621	0.472	3
725	757	725_Y	757_A	0.2256	0.62	0.471	32
503	535	503_Y	535_A	0.2251	0.619	0.469	32
441	456	441_N	456_L	0.2249	0.618	0.467	15
504	507	504_N	507_L	0.2243	0.617	0.466	3
493	527	493_K	527_H	0.2243	0.617	0.466	34
215	237	215_I	237_A	0.2241	0.616	0.464	22
267	271	267_A	271_L	0.2235	0.615	0.462	4
659	690	659_F	690_L	0.2233	0.614	0.46	31
289	304	289_K	304_L	0.2231	0.614	0.46	15
376	531	376_D	531_K	0.2231	0.613	0.459	155
188	220	188_M	220_C	0.223	0.613	0.459	32
354	357	354_D	357_T	0.2228	0.613	0.459	3
602	605	602_I	605_A	0.2225	0.612	0.457	3
480	613	480_K	613_L	0.2223	0.611	0.455	133
188	216	188_M	216_N	0.2222	0.611	0.455	28
285	288	285_Y	288_A	0.2221	0.611	0.455	3
313	339	313_S	339_I	0.2217	0.61	0.454	26
657	687	657_I	687_A	0.2216	0.609	0.452	30
622	625	622_A	625_R	0.2215	0.609	0.452	3
485	514	485_N	514_N	0.2214	0.609	0.452	29
152	164	152_A	164_A	0.2213	0.609	0.452	12
287	290	287_S	290_I	0.2213	0.608	0.45	3
714	749	714_T	749_L	0.2212	0.608	0.45	35
716	753	716_A	753_A	0.2212	0.608	0.45	37
401	446	401_Q	446_V	0.221	0.608	0.45	45
266	270	266_E	270_M	0.221	0.608	0.45	4
633	637	633_L	637_L	0.221	0.608	0.45	4
697	715	697_I	715_L	0.2202	0.606	0.447	18
770	773	770_S	773_T	0.2197	0.604	0.443	3
507	602	507_L	602_I	0.2197	0.604	0.443	95
285	309	285_Y	309_N	0.2195	0.604	0.443	24
360	392	360_Y	392_K	0.2194	0.603	0.442	32
358	393	358_G	393_D	0.2193	0.603	0.442	35
256	259	256_L	259_Y	0.2191	0.602	0.44	3
632	700	632_I	700_L	0.2188	0.602	0.44	68
366	620	366_R	620_K	0.2188	0.602	0.44	254
658	696	658_H	696_K	0.2182	0.6	0.437	38
289	318	289_K	318_L	0.2175	0.598	0.433	29
460	471	460_K	471_N	0.2173	0.598	0.433	11
388	404	388_V	404_F	0.2173	0.598	0.433	16
162	166	162_E	166_K	0.2172	0.597	0.432	4
276	279	276_M	279_Y	0.2171	0.597	0.432	3
313	436	313_S	436_Y	0.2169	0.596	0.43	123
367	371	367_L	371_Y	0.2169	0.596	0.43	4
444	510	444_D	510_A	0.2168	0.596	0.43	66
305	308	305_N	308_G	0.2167	0.596	0.43	3
713	743	713_Q	743_D	0.2166	0.596	0.43	30
744	748	744_T	748_F	0.2166	0.596	0.43	4
600	627	600_S	627_E	0.2166	0.595	0.428	27
748	779	748_F	779_E	0.2162	0.594	0.427	31
310	343	310_F	343_F	0.2161	0.594	0.427	33
726	759	726_E	759_N	0.216	0.594	0.427	33
289	315	289_K	315_S	0.216	0.594	0.427	26
368	489	368_Q	489_Q	0.2159	0.594	0.427	121
521	525	521_H	525_S	0.2151	0.591	0.422	4
233	237	233_Y	237_A	0.2147	0.59	0.42	4
441	444	441_N	444_D	0.2145	0.59	0.42	3
716	749	716_A	749_L	0.214	0.588	0.417	33
605	608	605_A	608_A	0.2138	0.588	0.417	3
502	506	502_H	506_A	0.2136	0.587	0.415	4
516	611	516_E	611_N	0.2136	0.587	0.415	95
659	714	659_F	714_T	0.2134	0.587	0.415	55
635	699	635_N	699_E	0.2133	0.587	0.415	64
218	250	218_A	250_Y	0.2133	0.586	0.413	32
229	233	229_K	233_Y	0.2132	0.586	0.413	4
713	748	713_Q	748_F	0.213	0.586	0.413	35
692	696	692_L	696_K	0.2128	0.585	0.412	4
156	164	156_Y	164_A	0.2128	0.585	0.412	8
693	700	693_E	700_L	0.2126	0.585	0.412	7
231	263	231_R	263_Y	0.2123	0.584	0.41	32
597	624	597_T	624_L	0.2123	0.584	0.41	27
301	519	301_I	519_Y	0.212	0.583	0.408	218
774	780	774_D	780_S	0.2117	0.582	0.407	6
185	216	185_V	216_N	0.2116	0.582	0.407	31
338	493	338_K	493_K	0.2115	0.582	0.407	155
735	742	735_L	742_K	0.2111	0.58	0.403	7
691	694	691_N	694_R	0.2109	0.58	0.403	3
479	484	479_Q	484_A	0.2103	0.578	0.4	5
389	392	389_R	392_K	0.2102	0.578	0.4	3
262	267	262_G	267_A	0.2101	0.578	0.4	5
181	210	181_Y	210_Q	0.21	0.577	0.398	29
479	513	479_Q	513_Q	0.2099	0.577	0.398	34
184	216	184_G	216_N	0.2096	0.576	0.397	32
788	791	788_Y	791_V	0.2096	0.576	0.397	3
405	451	405_S	451_D	0.2095	0.576	0.397	46
444	449	444_D	449_S	0.2093	0.576	0.397	5
301	364	301_I	364_L	0.2093	0.575	0.395	63
697	718	697_I	718_L	0.2093	0.575	0.395	21
367	488	367_L	488_F	0.2092	0.575	0.395	121
744	774	744_T	774_D	0.2091	0.575	0.395	30
200	204	200_F	204_I	0.2089	0.574	0.393	4
456	474	456_L	474_N	0.2088	0.574	0.393	18
468	600	468_K	600_S	0.2086	0.574	0.393	132
710	714	710_G	714_T	0.2084	0.573	0.392	4
286	315	286_L	315_S	0.208	0.572	0.39	29
181	184	181_Y	184_G	0.2077	0.571	0.388	3
713	745	713_Q	745_K	0.2076	0.571	0.388	32
293	356	293_K	356_K	0.2076	0.571	0.388	63
314	345	314_L	345_Q	0.2075	0.571	0.388	31