i	j	i_id	j_id	r_sco	s_sco	prob	distance
343	346	343_Q	346_K	1.5561	4.054	1	3
497	500	497_N	500_A	1.5454	4.026	1	3
571	574	571_N	574_Q	1.5373	4.005	1	3
381	384	381_Q	384_I	1.5334	3.995	1	3
306	309	306_E	309_K	1.5178	3.954	1	3
603	606	603_Q	606_Q	1.5158	3.949	1	3
269	272	269_Q	272_D	1.5136	3.943	1	3
642	645	642_D	645_Q	1.4809	3.858	1	3
536	539	536_N	539_N	1.4672	3.822	1	3
419	422	419_R	422_D	1.4193	3.698	1	3
718	721	718_K	721_E	1.4022	3.653	1	3
222	235	222_T	235_K	1.3021	3.392	1	13
755	758	755_N	758_A	1.3012	3.39	1	3
456	461	456_D	461_F	1.2941	3.371	1	5
678	681	678_M	681_T	1.1293	2.942	1	3
185	188	185_N	188_Q	1.0909	2.842	1	3
298	314	298_A	314_Y	0.9251	2.41	1	16
528	544	528_L	544_F	0.9006	2.346	1	16
335	351	335_A	351_I	0.8938	2.329	1	16
489	505	489_V	505_K	0.8736	2.276	1	16
634	650	634_F	650_L	0.8565	2.231	1	16
563	579	563_L	579_I	0.853	2.222	1	16
411	427	411_A	427_L	0.8205	2.138	1	16
595	611	595_A	611_S	0.8175	2.13	1	16
261	277	261_L	277_M	0.7978	2.078	1	16
448	466	448_D	466_Y	0.7817	2.037	1	18
390	410	390_E	410_L	0.7671	1.999	1	20
373	389	373_A	389_Y	0.7608	1.982	1	16
428	447	428_D	447_S	0.7485	1.95	1	19
527	543	527_D	543_I	0.7399	1.928	1	16
278	297	278_S	297_Y	0.7154	1.864	1	19
710	726	710_L	726_L	0.7133	1.858	1	16
407	426	407_L	426_Y	0.7105	1.851	1	19
580	594	580_D	594_K	0.7026	1.83	1	14
294	313	294_K	313_I	0.6946	1.81	1	19
524	543	524_A	543_I	0.6918	1.802	1	19
591	610	591_G	610_I	0.6917	1.802	1	19
531	539	531_A	539_N	0.6894	1.796	1	8
506	527	506_D	527_D	0.6871	1.79	1	21
241	260	241_K	260_M	0.6816	1.776	1	19
214	240	214_L	240_A	0.6802	1.772	1	26
467	488	467_T	488_D	0.6753	1.759	1	21
633	649	633_Q	649_I	0.6735	1.755	1	16
315	334	315_E	334_L	0.6715	1.749	1	19
608	612	608_I	612_K	0.6642	1.731	0.999	4
594	610	594_K	610_I	0.6619	1.724	0.999	16
444	465	444_K	465_R	0.6596	1.719	0.999	21
257	276	257_L	276_T	0.6596	1.718	0.999	19
352	372	352_N	372_L	0.6592	1.717	0.999	20
747	763	747_A	763_L	0.658	1.714	0.999	16
331	350	331_A	350_Y	0.6569	1.711	0.999	19
559	578	559_K	578_Y	0.6561	1.709	0.999	19
210	239	210_I	239_D	0.6509	1.696	0.999	29
713	721	713_L	721_E	0.6478	1.688	0.999	8
647	651	647_I	651_Q	0.6454	1.682	0.999	4
311	315	311_V	315_E	0.6431	1.676	0.999	4
598	606	598_L	606_Q	0.6429	1.675	0.999	8
706	725	706_E	725_V	0.6289	1.639	0.999	19
372	388	372_L	388_I	0.6271	1.634	0.999	16
713	718	713_L	718_K	0.6258	1.63	0.999	5
485	504	485_L	504_Y	0.6254	1.629	0.999	19
545	562	545_M	562_M	0.6254	1.629	0.999	17
297	301	297_Y	301_I	0.6238	1.625	0.999	4
492	500	492_Y	500_A	0.6236	1.625	0.999	8
260	264	260_M	264_Y	0.6232	1.624	0.999	4
455	459	455_G	459_A	0.6229	1.623	0.999	4
369	388	369_S	388_I	0.6223	1.621	0.999	19
213	217	213_K	217_Q	0.62	1.615	0.999	4
314	333	314_Y	333_S	0.6194	1.614	0.999	19
488	504	488_D	504_Y	0.6187	1.612	0.999	16
743	762	743_L	762_S	0.6165	1.606	0.999	19
264	272	264_Y	272_D	0.6157	1.604	0.999	8
566	574	566_L	574_Q	0.615	1.602	0.999	8
670	686	670_L	686_A	0.6138	1.599	0.999	16
334	350	334_L	350_Y	0.6137	1.599	0.999	16
633	637	633_Q	637_L	0.6086	1.586	0.999	4
727	746	727_T	746_Q	0.6073	1.582	0.998	19
338	346	338_L	346_K	0.607	1.581	0.998	8
301	309	301_I	309_K	0.6069	1.581	0.998	8
630	649	630_Y	649_I	0.6067	1.581	0.998	19
260	276	260_M	276_T	0.6048	1.576	0.998	16
301	313	301_I	313_I	0.6043	1.574	0.998	12
562	578	562_M	578_Y	0.6011	1.566	0.998	16
297	313	297_Y	313_I	0.5989	1.56	0.998	16
527	531	527_D	531_A	0.5981	1.558	0.998	4
750	758	750_Y	758_A	0.5951	1.55	0.998	8
562	566	562_M	566_L	0.5914	1.541	0.998	4
612	633	612_K	633_Q	0.5903	1.538	0.998	21
386	390	386_A	390_E	0.5884	1.533	0.998	4
709	713	709_Y	713_L	0.5871	1.53	0.998	4
274	278	274_E	278_S	0.5846	1.523	0.998	4
502	506	502_L	506_D	0.5834	1.52	0.998	4
447	451	447_S	451_F	0.5833	1.52	0.998	4
177	193	177_I	193_A	0.583	1.519	0.998	16
237	241	237_I	241_K	0.5826	1.518	0.998	4
594	598	594_K	598_L	0.5824	1.517	0.998	4
410	414	410_L	414_L	0.5803	1.512	0.998	4
637	645	637_L	645_Q	0.5799	1.511	0.998	8
613	616	613_D	616_N	0.5771	1.503	0.997	3
264	269	264_Y	269_Q	0.5766	1.502	0.997	5
348	352	348_I	352_N	0.5743	1.496	0.997	4
709	725	709_Y	725_V	0.5722	1.491	0.997	16
492	504	492_Y	504_Y	0.572	1.49	0.997	12
277	296	277_M	296_D	0.5708	1.487	0.997	19
723	727	723_L	727_T	0.5688	1.482	0.997	4
573	601	573_E	601_N	0.5678	1.479	0.997	28
581	584	581_K	584_N	0.5675	1.478	0.997	3
376	388	376_F	388_I	0.5672	1.478	0.997	12
424	428	424_K	428_D	0.5659	1.474	0.997	4
505	526	505_K	526_N	0.5653	1.473	0.997	21
451	461	451_F	461_F	0.5647	1.471	0.997	10
746	762	746_Q	762_S	0.5644	1.47	0.997	16
221	233	221_Y	233_L	0.5624	1.465	0.997	12
334	338	334_L	338_L	0.5589	1.456	0.996	4
652	655	652_I	655_S	0.5577	1.453	0.996	3
376	384	376_F	384_I	0.5562	1.449	0.996	8
447	465	447_S	465_R	0.5518	1.438	0.996	18
410	426	410_L	426_Y	0.5501	1.433	0.996	16
414	422	414_L	422_D	0.5465	1.424	0.996	8
721	724	721_E	724_A	0.546	1.423	0.995	3
531	543	531_A	543_I	0.5444	1.418	0.995	12
338	350	338_L	350_Y	0.5425	1.413	0.995	12
598	603	598_L	603_Q	0.5407	1.409	0.995	5
576	597	576_L	597_I	0.5385	1.403	0.995	21
372	376	372_L	376_F	0.5372	1.399	0.995	4
466	487	466_Y	487_E	0.5347	1.393	0.994	21
576	580	576_L	580_D	0.5346	1.393	0.994	4
193	212	193_A	212_Y	0.5325	1.387	0.994	19
194	213	194_Q	213_K	0.5318	1.385	0.994	19
338	343	338_L	343_Q	0.528	1.376	0.994	5
645	648	645_Q	648_K	0.527	1.373	0.994	3
389	409	389_Y	409_D	0.5249	1.368	0.993	20
463	491	463_H	491_L	0.5226	1.362	0.993	28
488	492	488_D	492_Y	0.5207	1.357	0.993	4
502	527	502_L	527_D	0.5174	1.348	0.992	25
311	334	311_V	334_L	0.5152	1.342	0.992	23
758	761	758_A	761_E	0.5133	1.337	0.992	3
274	297	274_E	297_Y	0.512	1.334	0.992	23
346	349	346_K	349_E	0.5113	1.332	0.992	3
301	306	301_I	306_E	0.5095	1.327	0.991	5
190	213	190_V	213_K	0.5085	1.325	0.991	23
240	259	240_A	259_I	0.5078	1.323	0.991	19
386	410	386_A	410_L	0.5053	1.317	0.991	24
451	465	451_F	465_R	0.5035	1.312	0.99	14
386	417	386_A	417_A	0.5006	1.304	0.99	31
746	750	746_Q	750_Y	0.4996	1.302	0.99	4
728	731	728_D	731_K	0.4987	1.299	0.989	3
637	642	637_L	642_D	0.4968	1.294	0.989	5
723	749	723_L	749_T	0.4956	1.291	0.989	26
531	536	531_A	536_N	0.495	1.29	0.989	5
485	507	485_L	507_L	0.4932	1.285	0.988	22
726	745	726_L	745_I	0.4904	1.278	0.988	19
195	198	195_N	198_N	0.4895	1.275	0.988	3
463	467	463_H	467_T	0.4891	1.274	0.988	4
502	530	502_L	530_N	0.4882	1.272	0.987	28
274	300	274_E	300_Y	0.4867	1.268	0.987	26
308	341	308_E	341_N	0.486	1.266	0.987	33
351	371	351_I	371_E	0.4843	1.262	0.987	20
264	276	264_Y	276_T	0.484	1.261	0.986	12
271	304	271_A	304_L	0.4832	1.259	0.986	33
217	235	217_Q	235_K	0.4822	1.256	0.986	18
541	565	541_A	565_C	0.4814	1.254	0.986	24
386	413	386_A	413_V	0.4802	1.251	0.985	27
348	372	348_I	372_L	0.4799	1.25	0.985	24
688	691	688_K	691_D	0.4787	1.247	0.985	3
309	312	309_K	312_N	0.4781	1.245	0.985	3
723	746	723_L	746_Q	0.4779	1.245	0.985	23
427	446	427_L	446_A	0.4765	1.241	0.984	19
376	381	376_F	381_Q	0.4758	1.24	0.984	5
213	239	213_K	239_D	0.4758	1.24	0.984	26
318	330	318_Y	330_A	0.4741	1.235	0.984	12
760	764	760_K	764_K	0.4739	1.235	0.984	4
666	685	666_Y	685_Y	0.4703	1.225	0.983	19
541	545	541_A	545_M	0.4681	1.22	0.982	4
669	673	669_L	673_A	0.4671	1.217	0.982	4
673	681	673_A	681_T	0.467	1.217	0.982	8
576	594	576_L	594_K	0.4665	1.215	0.981	18
242	245	242_N	245_R	0.4656	1.213	0.981	3
463	488	463_H	488_D	0.4652	1.212	0.981	25
316	319	316_N	319_F	0.4646	1.211	0.981	3
373	392	373_A	392_A	0.4646	1.211	0.981	19
750	755	750_Y	755_N	0.4638	1.208	0.981	5
190	194	190_V	194_Q	0.4636	1.208	0.981	4
261	280	261_L	280_L	0.463	1.206	0.98	19
576	601	576_L	601_N	0.4619	1.203	0.98	25
606	609	606_Q	609_K	0.4595	1.197	0.979	3
180	188	180_E	188_Q	0.459	1.196	0.979	8
235	238	235_K	238_D	0.4587	1.195	0.979	3
274	304	274_E	304_L	0.4582	1.194	0.979	30
353	356	353_T	356_K	0.4577	1.193	0.978	3
651	669	651_Q	669_L	0.4576	1.192	0.978	18
279	282	279_I	282_N	0.4575	1.192	0.978	3
500	503	500_A	503_A	0.4569	1.19	0.978	3
683	687	683_L	687_P	0.4561	1.188	0.978	4
647	669	647_I	669_L	0.4559	1.188	0.978	22
507	510	507_L	510_S	0.4554	1.186	0.977	3
710	729	710_L	729_L	0.4551	1.186	0.977	19
237	260	237_I	260_M	0.455	1.185	0.977	23
499	534	499_S	534_A	0.4541	1.183	0.977	35
298	317	298_A	317_T	0.4539	1.183	0.977	19
424	450	424_K	450_V	0.4522	1.178	0.976	26
574	577	574_Q	577_D	0.4516	1.177	0.976	3
615	629	615_A	629_A	0.4516	1.176	0.976	14
524	546	524_A	546_R	0.4506	1.174	0.976	22
461	464	461_F	464_Q	0.4498	1.172	0.975	3
348	375	348_I	375_L	0.4497	1.172	0.975	27
355	368	355_L	368_R	0.4487	1.169	0.975	13
348	376	348_I	376_F	0.4474	1.165	0.974	28
681	684	681_T	684_T	0.4461	1.162	0.974	3
707	745	707_F	745_I	0.4459	1.162	0.974	38
579	593	579_I	593_Q	0.4457	1.161	0.973	14
747	766	747_A	766_C	0.4449	1.159	0.973	19
345	379	345_N	379_K	0.4446	1.158	0.973	34
608	633	608_I	633_Q	0.4446	1.158	0.973	25
295	333	295_L	333_S	0.4441	1.157	0.973	38
566	571	566_L	571_N	0.4432	1.155	0.972	5
391	394	391_D	394_A	0.441	1.149	0.971	3
502	531	502_L	531_A	0.4404	1.147	0.971	29
591	613	591_G	613_D	0.44	1.146	0.971	22
563	582	563_L	582_N	0.4399	1.146	0.971	19
311	341	311_V	341_N	0.4396	1.145	0.97	30
237	263	237_I	263_T	0.4382	1.142	0.97	26
468	471	468_D	471_K	0.4376	1.14	0.969	3
634	646	634_F	646_A	0.4359	1.136	0.969	12
598	610	598_L	610_I	0.4349	1.133	0.968	12
187	220	187_N	220_L	0.4327	1.127	0.967	33
765	768	765_Q	768_E	0.4303	1.121	0.965	3
414	419	414_L	419_R	0.43	1.12	0.965	5
580	584	580_D	584_N	0.4299	1.12	0.965	4
669	685	669_L	685_Y	0.4274	1.114	0.964	16
424	447	424_K	447_S	0.4273	1.113	0.963	23
492	497	492_Y	497_N	0.4267	1.112	0.963	5
566	578	566_L	578_Y	0.4257	1.109	0.962	12
637	649	637_L	649_I	0.4253	1.108	0.962	12
390	394	390_E	394_A	0.4249	1.107	0.962	4
614	629	614_I	629_A	0.4249	1.107	0.962	15
630	652	630_Y	652_I	0.4248	1.107	0.962	22
348	379	348_I	379_K	0.4237	1.104	0.961	31
538	569	538_I	569_T	0.4234	1.103	0.961	31
592	632	592_L	632_L	0.4218	1.099	0.96	40
294	316	294_K	316_N	0.4217	1.099	0.96	22
559	581	559_K	581_K	0.4213	1.097	0.959	22
460	495	460_S	495_E	0.4202	1.095	0.959	35
720	753	720_E	753_M	0.4201	1.095	0.959	33
713	725	713_L	725_V	0.4194	1.093	0.958	12
331	353	331_A	353_T	0.4192	1.092	0.958	22
197	209	197_I	209_F	0.4189	1.091	0.958	12
564	593	564_A	593_Q	0.4185	1.09	0.957	29
176	180	176_R	180_E	0.4163	1.084	0.956	4
448	469	448_D	469_L	0.4151	1.082	0.955	21
421	454	421_S	454_L	0.4151	1.081	0.955	33
583	591	583_Y	591_G	0.4145	1.08	0.954	8
272	275	272_D	275_Y	0.4144	1.08	0.954	3
723	753	723_L	753_M	0.4136	1.078	0.954	30
539	542	539_N	542_N	0.4134	1.077	0.954	3
217	239	217_Q	239_D	0.4127	1.075	0.953	22
611	632	611_S	632_L	0.4123	1.074	0.953	21
311	338	311_V	338_L	0.4104	1.069	0.951	27
544	561	544_F	561_Q	0.4099	1.068	0.951	17
608	640	608_I	640_L	0.4096	1.067	0.95	32
429	432	429_L	432_D	0.4082	1.063	0.949	3
750	762	750_Y	762_S	0.4079	1.063	0.949	12
463	495	463_H	495_E	0.4074	1.061	0.948	32
190	220	190_V	220_L	0.4065	1.059	0.948	30
682	686	682_I	686_A	0.4061	1.058	0.947	4
384	387	384_I	387_S	0.4059	1.058	0.947	3
190	216	190_V	216_A	0.4058	1.057	0.947	26
383	417	383_D	417_A	0.4042	1.053	0.946	34
489	504	489_V	504_Y	0.4041	1.053	0.946	15
652	656	652_I	656_F	0.4038	1.052	0.945	4
354	368	354_I	368_R	0.4029	1.05	0.945	14
318	331	318_Y	331_A	0.4027	1.049	0.944	13
730	743	730_L	743_L	0.4013	1.046	0.943	13
237	267	237_I	267_L	0.4011	1.045	0.943	30
595	614	595_A	614_I	0.4006	1.044	0.942	19
284	287	284_Q	287_N	0.4	1.042	0.942	3
180	185	180_E	185_N	0.398	1.037	0.94	5
196	209	196_A	209_F	0.398	1.037	0.94	13
728	732	728_D	732_L	0.3974	1.035	0.939	4
683	716	683_L	716_I	0.3954	1.03	0.937	33
214	243	214_L	243_W	0.3949	1.029	0.937	29
546	549	546_R	549_A	0.3946	1.028	0.936	3
281	293	281_D	293_S	0.3943	1.027	0.936	12
747	762	747_A	762_S	0.3943	1.027	0.936	15
217	222	217_Q	222_T	0.3941	1.027	0.936	5
234	267	234_E	267_L	0.3931	1.024	0.934	33
355	369	355_L	369_S	0.3923	1.022	0.934	14
300	304	300_Y	304_L	0.3923	1.022	0.934	4
687	709	687_P	709_Y	0.3909	1.019	0.932	22
467	471	467_T	471_K	0.3903	1.017	0.931	4
444	468	444_K	468_D	0.3901	1.016	0.931	24
422	425	422_D	425_K	0.3899	1.016	0.931	3
393	407	393_F	407_L	0.3887	1.013	0.93	14
626	629	626_N	629_A	0.3883	1.012	0.929	3
374	409	374_K	409_D	0.3877	1.01	0.928	35
257	279	257_L	279_I	0.3872	1.009	0.928	22
388	392	388_I	392_A	0.387	1.008	0.927	4
612	645	612_K	645_Q	0.3857	1.005	0.926	33
547	558	547_F	558_N	0.3852	1.004	0.926	11
613	617	613_D	617_S	0.3848	1.002	0.925	4
761	765	761_E	765_Q	0.3846	1.002	0.925	4
377	413	377_N	413_V	0.3842	1.001	0.924	36
441	469	441_D	469_L	0.3841	1.001	0.924	28
712	716	712_A	716_I	0.3841	1.001	0.924	4
335	354	335_A	354_I	0.3839	1	0.924	19
541	562	541_A	562_M	0.3827	0.997	0.922	21
647	672	647_I	672_Y	0.3826	0.997	0.922	25
644	676	644_N	676_H	0.382	0.995	0.921	32
605	640	605_P	640_L	0.3816	0.994	0.921	35
393	406	393_F	406_T	0.3814	0.994	0.921	13
634	653	634_F	653_L	0.3813	0.993	0.92	19
502	534	502_L	534_A	0.3805	0.991	0.919	32
576	598	576_L	598_L	0.3802	0.991	0.919	22
415	427	415_S	427_L	0.38	0.99	0.919	12
407	429	407_L	429_L	0.3791	0.988	0.918	22
463	492	463_H	492_Y	0.3783	0.986	0.917	29
411	430	411_A	430_Y	0.378	0.985	0.916	19
706	728	706_E	728_D	0.3777	0.984	0.915	22
503	507	503_A	507_L	0.3776	0.984	0.915	4
414	426	414_L	426_Y	0.3775	0.983	0.915	12
583	590	583_Y	590_Y	0.3772	0.983	0.915	7
612	616	612_K	616_N	0.377	0.982	0.914	4
548	559	548_S	559_K	0.3767	0.982	0.914	11
727	731	727_T	731_K	0.3756	0.978	0.912	4
386	414	386_A	414_L	0.3753	0.978	0.912	28
508	523	508_I	523_A	0.3752	0.977	0.912	15
328	354	328_A	354_I	0.3747	0.976	0.911	26
445	449	445_K	449_E	0.3746	0.976	0.911	4
279	283	279_I	283_E	0.3744	0.975	0.911	4
390	422	390_E	422_D	0.3739	0.974	0.91	32
729	742	729_L	742_A	0.3738	0.974	0.91	13
247	250	247_F	250_D	0.3733	0.973	0.909	3
311	337	311_V	337_N	0.3718	0.969	0.907	26
337	341	337_N	341_N	0.3718	0.969	0.907	4
489	508	489_V	508_I	0.3716	0.968	0.907	19
650	668	650_L	668_A	0.3701	0.964	0.904	18
299	314	299_D	314_Y	0.3699	0.964	0.904	15
257	280	257_L	280_L	0.3695	0.963	0.904	23
352	356	352_N	356_K	0.3683	0.96	0.902	4
703	729	703_P	729_L	0.3683	0.959	0.901	26
408	412	408_K	412_L	0.3676	0.958	0.901	4
215	240	215_R	240_A	0.3662	0.954	0.898	25
638	650	638_L	650_L	0.3656	0.953	0.897	12
254	280	254_S	280_L	0.3655	0.952	0.897	26
188	191	188_Q	191_I	0.3653	0.952	0.897	3
276	280	276_T	280_L	0.3646	0.95	0.896	4
274	301	274_E	301_I	0.3645	0.95	0.896	27
424	454	424_K	454_L	0.3638	0.948	0.894	30
412	446	412_L	446_A	0.3635	0.947	0.894	34
493	505	493_Y	505_K	0.3634	0.947	0.894	12
291	317	291_Q	317_T	0.3632	0.946	0.893	26
541	569	541_A	569_T	0.3615	0.942	0.89	28
176	192	176_R	192_D	0.3614	0.942	0.89	16
470	484	470_M	484_A	0.3596	0.937	0.887	14
560	593	560_K	593_Q	0.3591	0.936	0.886	33
449	487	449_E	487_E	0.3589	0.935	0.886	38
711	745	711_D	745_I	0.3575	0.931	0.883	34
332	336	332_M	336_K	0.3556	0.926	0.879	4
498	530	498_F	530_N	0.3553	0.926	0.879	32
482	508	482_N	508_I	0.3545	0.924	0.878	26
464	468	464_Q	468_D	0.3545	0.924	0.878	4
490	526	490_A	526_N	0.3537	0.921	0.875	36
428	432	428_D	432_D	0.353	0.92	0.875	4
564	579	564_A	579_I	0.3525	0.918	0.873	15
200	203	200_Y	203_S	0.3524	0.918	0.873	3
420	453	420_S	453_A	0.3523	0.918	0.873	33
525	529	525_I	529_K	0.3521	0.917	0.872	4
404	430	404_E	430_Y	0.3519	0.917	0.872	26
242	246	242_N	246_T	0.3513	0.915	0.871	4
608	636	608_I	636_S	0.3508	0.914	0.87	28
317	330	317_T	330_A	0.3495	0.911	0.868	13
459	491	459_A	491_L	0.3484	0.908	0.865	32
180	192	180_E	192_D	0.3484	0.908	0.865	12
263	267	263_T	267_L	0.3474	0.905	0.863	4
525	561	525_I	561_Q	0.3453	0.9	0.859	36
424	451	424_K	451_F	0.3445	0.897	0.856	27
451	456	451_F	456_D	0.3442	0.897	0.856	5
371	374	371_E	374_K	0.3438	0.896	0.855	3
711	726	711_D	726_L	0.3437	0.895	0.855	15
587	590	587_S	590_Y	0.3435	0.895	0.855	3
210	242	210_I	242_N	0.3433	0.894	0.854	32
273	277	273_V	277_M	0.3433	0.894	0.854	4
298	310	298_A	310_A	0.3431	0.894	0.854	12
648	652	648_K	652_I	0.3428	0.893	0.853	4
375	379	375_L	379_K	0.3422	0.892	0.852	4
748	763	748_L	763_L	0.3417	0.89	0.85	15
580	606	580_D	606_Q	0.3411	0.889	0.849	26
724	728	724_A	728_D	0.3409	0.888	0.849	4
545	574	545_M	574_Q	0.3402	0.886	0.847	29
369	391	369_S	391_D	0.3396	0.885	0.846	22
751	763	751_E	763_L	0.339	0.883	0.844	12
667	708	667_D	708_I	0.3389	0.883	0.844	41
336	351	336_K	351_I	0.3389	0.883	0.844	15
582	590	582_N	590_Y	0.3383	0.881	0.842	8
302	307	302_Y	307_K	0.3383	0.881	0.842	5
596	611	596_S	611_S	0.3383	0.881	0.842	15
280	293	280_L	293_S	0.3382	0.881	0.842	13
485	508	485_L	508_I	0.3381	0.881	0.842	23
265	277	265_I	277_M	0.3379	0.88	0.841	12
559	582	559_K	582_N	0.3378	0.88	0.841	23
370	409	370_L	409_D	0.3375	0.879	0.84	39
710	725	710_L	725_V	0.3371	0.878	0.839	15
236	240	236_M	240_A	0.3365	0.877	0.839	4
302	314	302_Y	314_Y	0.3363	0.876	0.838	12
733	736	733_K	736_D	0.3362	0.876	0.838	3
310	337	310_A	337_N	0.3361	0.876	0.838	27
551	555	551_D	555_K	0.3361	0.876	0.838	4
743	765	743_L	765_Q	0.3358	0.875	0.837	22
239	243	239_D	243_W	0.3356	0.874	0.836	4
243	256	243_W	256_V	0.3348	0.872	0.834	13
302	337	302_Y	337_N	0.3347	0.872	0.834	35
509	523	509_E	523_A	0.3345	0.871	0.833	14
581	585	581_K	585_E	0.3341	0.87	0.832	4
435	474	435_L	474_A	0.3341	0.87	0.832	39
313	317	313_I	317_T	0.334	0.87	0.832	4
403	406	403_Y	406_T	0.3339	0.87	0.832	3
190	217	190_V	217_Q	0.3337	0.869	0.831	27
744	748	744_Y	748_L	0.3336	0.869	0.831	4
615	630	615_A	630_Y	0.3334	0.869	0.831	15
499	503	499_S	503_A	0.3333	0.868	0.83	4
723	750	723_L	750_Y	0.3332	0.868	0.83	27
420	450	420_S	450_V	0.3332	0.868	0.83	30
651	655	651_Q	655_S	0.3327	0.867	0.829	4
317	320	317_T	320_N	0.3326	0.866	0.828	3
596	632	596_S	632_L	0.3323	0.866	0.828	36
634	649	634_F	649_I	0.3323	0.866	0.828	15
683	712	683_L	712_A	0.3323	0.866	0.828	29
521	547	521_E	547_F	0.3322	0.865	0.827	26
498	533	498_F	533_K	0.332	0.865	0.827	35
710	722	710_L	722_S	0.3318	0.864	0.826	12
627	653	627_F	653_L	0.3314	0.863	0.825	26
336	371	336_K	371_E	0.3311	0.863	0.825	35
382	413	382_F	413_V	0.3309	0.862	0.824	31
563	575	563_L	575_A	0.3307	0.862	0.824	12
489	501	489_V	501_I	0.3306	0.861	0.823	12
413	417	413_V	417_A	0.3304	0.861	0.823	4
298	313	298_A	313_I	0.3298	0.859	0.821	15
214	236	214_L	236_M	0.3297	0.859	0.821	22
707	711	707_F	711_D	0.3297	0.859	0.821	4
238	242	238_D	242_N	0.3293	0.858	0.82	4
177	196	177_I	196_A	0.3292	0.858	0.82	19
452	466	452_F	466_Y	0.3292	0.858	0.82	14
294	317	294_K	317_T	0.3288	0.857	0.819	23
391	395	391_D	395_K	0.3283	0.855	0.817	4
673	678	673_A	678_M	0.3282	0.855	0.817	5
460	464	460_S	464_Q	0.3281	0.855	0.817	4
588	614	588_I	614_I	0.3281	0.855	0.817	26
548	558	548_S	558_N	0.3278	0.854	0.816	10
350	353	350_Y	353_T	0.3276	0.854	0.816	3
377	389	377_N	389_Y	0.3276	0.853	0.815	12
582	585	582_N	585_E	0.3271	0.852	0.814	3
312	316	312_N	316_N	0.3267	0.851	0.813	4
764	768	764_K	768_E	0.3257	0.849	0.811	4
465	468	465_R	468_D	0.3249	0.846	0.808	3
486	490	486_D	490_A	0.3247	0.846	0.808	4
392	406	392_A	406_T	0.3246	0.846	0.808	14
407	430	407_L	430_Y	0.3243	0.845	0.807	23
538	542	538_I	542_N	0.3235	0.843	0.804	4
350	354	350_Y	354_I	0.3233	0.842	0.803	4
430	443	430_Y	443_I	0.323	0.842	0.803	13
470	485	470_M	485_L	0.323	0.841	0.802	15
573	577	573_E	577_D	0.323	0.841	0.802	4
431	444	431_M	444_K	0.322	0.839	0.8	13
635	650	635_L	650_L	0.3211	0.837	0.798	15
369	392	369_S	392_A	0.3204	0.835	0.796	23
646	650	646_A	650_L	0.3203	0.834	0.795	4
448	465	448_D	465_R	0.3202	0.834	0.795	17
528	547	528_L	547_F	0.32	0.834	0.795	19
726	749	726_L	749_T	0.3199	0.833	0.793	23
687	691	687_P	691_D	0.3194	0.832	0.792	4
529	561	529_K	561_Q	0.3194	0.832	0.792	32
347	351	347_A	351_I	0.3194	0.832	0.792	4
411	423	411_A	423_A	0.3189	0.831	0.791	12
281	294	281_D	294_K	0.3185	0.83	0.79	13
377	382	377_N	382_F	0.318	0.828	0.788	5
241	245	241_K	245_R	0.3173	0.827	0.787	4
765	769	765_Q	769_I	0.3172	0.826	0.785	4
686	708	686_A	708_I	0.3171	0.826	0.785	22
448	462	448_D	462_L	0.317	0.826	0.785	14
567	579	567_I	579_I	0.3168	0.825	0.784	12
719	753	719_N	753_M	0.3167	0.825	0.784	34
179	183	179_K	183_K	0.3167	0.825	0.784	4
192	196	192_D	196_A	0.3164	0.824	0.783	4
181	193	181_Y	193_A	0.316	0.823	0.782	12
749	753	749_T	753_M	0.3153	0.822	0.781	4
278	282	278_S	282_N	0.315	0.821	0.78	4
560	564	560_K	564_A	0.3146	0.82	0.778	4
542	546	542_N	546_R	0.3144	0.819	0.777	4
543	546	543_I	546_R	0.3142	0.819	0.777	3
506	510	506_D	510_S	0.3139	0.818	0.776	4
335	347	335_A	347_A	0.3137	0.817	0.775	12
233	263	233_L	263_T	0.3135	0.817	0.775	30
680	716	680_T	716_I	0.3134	0.816	0.774	36
608	637	608_I	637_L	0.3131	0.816	0.774	29
667	671	667_D	671_S	0.3125	0.814	0.771	4
331	354	331_A	354_I	0.3124	0.814	0.771	23
725	728	725_V	728_D	0.3123	0.814	0.771	3
421	460	421_S	460_S	0.312	0.813	0.77	39
591	614	591_G	614_I	0.3119	0.813	0.77	23
670	689	670_L	689_A	0.3114	0.811	0.768	19
595	610	595_A	610_I	0.3112	0.811	0.768	15
344	375	344_V	375_L	0.3112	0.811	0.768	31
415	450	415_S	450_V	0.3111	0.81	0.766	35
469	484	469_L	484_A	0.3107	0.809	0.765	15
195	199	195_N	199_R	0.3105	0.809	0.765	4
528	543	528_L	543_I	0.3098	0.807	0.763	15
563	578	563_L	578_Y	0.3092	0.806	0.761	15
597	601	597_I	601_N	0.309	0.805	0.76	4
647	676	647_I	676_H	0.3089	0.805	0.76	29
452	491	452_F	491_L	0.3089	0.805	0.76	39
445	487	445_K	487_E	0.3089	0.805	0.76	42
339	351	339_L	351_I	0.3087	0.804	0.759	12
361	368	361_Y	368_R	0.3087	0.804	0.759	7
714	749	714_T	749_T	0.3084	0.803	0.758	35
681	685	681_T	685_Y	0.3082	0.803	0.758	4
702	705	702_S	705_L	0.3081	0.803	0.758	3
528	540	528_L	540_A	0.3073	0.801	0.755	12
222	234	222_T	234_E	0.3067	0.799	0.752	12
197	210	197_I	210_I	0.3064	0.798	0.751	13
727	758	727_T	758_A	0.3064	0.798	0.751	31
609	612	609_K	612_K	0.3059	0.797	0.75	3
270	300	270_R	300_Y	0.305	0.795	0.747	30
630	653	630_Y	653_L	0.3031	0.79	0.741	23
618	629	618_R	629_A	0.303	0.79	0.741	11
509	524	509_E	524_A	0.303	0.789	0.739	15
244	257	244_T	257_L	0.3029	0.789	0.739	13
273	300	273_V	300_Y	0.3026	0.788	0.738	27
469	472	469_L	472_Q	0.3025	0.788	0.738	3
711	714	711_D	714_T	0.3023	0.788	0.738	3
623	626	623_D	626_N	0.3017	0.786	0.735	3
307	337	307_K	337_N	0.3015	0.786	0.735	30
530	534	530_N	534_A	0.3014	0.785	0.734	4
532	544	532_I	544_F	0.3013	0.785	0.734	12
672	676	672_Y	676_H	0.3006	0.783	0.731	4
332	368	332_M	368_R	0.3002	0.782	0.73	36
666	688	666_Y	688_K	0.3001	0.782	0.73	22
493	530	493_Y	530_N	0.3	0.782	0.73	37
714	722	714_T	722_S	0.2999	0.781	0.729	8
490	505	490_A	505_K	0.2998	0.781	0.729	15
358	361	358_N	361_Y	0.2997	0.781	0.729	3
429	433	429_L	433_D	0.2996	0.781	0.729	4
468	472	468_D	472_Q	0.2992	0.779	0.726	4
609	613	609_K	613_D	0.2991	0.779	0.726	4
595	607	595_A	607_V	0.2989	0.779	0.726	12
218	240	218_N	240_A	0.2981	0.777	0.723	22
428	461	428_D	461_F	0.2978	0.776	0.722	33
421	425	421_S	425_K	0.2978	0.776	0.722	4
258	262	258_H	262_R	0.2974	0.775	0.721	4
373	385	373_A	385_S	0.297	0.774	0.719	12
339	375	339_L	375_L	0.2969	0.774	0.719	36
549	584	549_A	584_N	0.2968	0.773	0.718	35
545	549	545_M	549_A	0.2965	0.773	0.718	4
724	727	724_A	727_T	0.2959	0.771	0.715	3
265	296	265_I	296_D	0.2958	0.771	0.715	31
181	186	181_Y	186_Y	0.2955	0.77	0.714	5
211	215	211_L	215_R	0.2954	0.77	0.714	4
630	656	630_Y	656_F	0.2952	0.769	0.712	26
473	476	473_Y	476_K	0.2951	0.769	0.712	3
556	582	556_I	582_N	0.2948	0.768	0.711	26
467	500	467_T	500_A	0.2947	0.768	0.711	33
191	195	191_I	195_N	0.2947	0.768	0.711	4
261	276	261_L	276_T	0.2946	0.768	0.711	15
491	495	491_L	495_E	0.2943	0.767	0.709	4
287	293	287_N	293_S	0.2934	0.765	0.706	6
315	338	315_E	338_L	0.2932	0.764	0.705	23
504	507	504_Y	507_L	0.2923	0.762	0.702	3
244	256	244_T	256_V	0.292	0.761	0.701	12
471	510	471_K	510_S	0.292	0.761	0.701	39
313	316	313_I	316_N	0.2916	0.76	0.699	3
315	319	315_E	319_F	0.2914	0.759	0.698	4
452	532	452_F	532_I	0.2904	0.756	0.694	80
194	198	194_Q	198_N	0.2903	0.756	0.694	4
683	709	683_L	709_Y	0.2902	0.756	0.694	26
411	426	411_A	426_Y	0.29	0.756	0.694	15
212	215	212_Y	215_R	0.2896	0.754	0.691	3
349	353	349_E	353_T	0.2894	0.754	0.691	4
216	220	216_A	220_L	0.2885	0.752	0.688	4
376	379	376_F	379_K	0.2883	0.751	0.686	3
276	279	276_T	279_I	0.2883	0.751	0.686	3
354	357	354_I	357_A	0.2883	0.751	0.686	3
262	277	262_R	277_M	0.2878	0.75	0.685	15
501	505	501_I	505_K	0.2871	0.748	0.682	4
387	391	387_S	391_D	0.287	0.748	0.682	4
335	350	335_A	350_Y	0.2867	0.747	0.68	15
517	520	517_T	520_L	0.2864	0.746	0.679	3
431	443	431_M	443_I	0.2863	0.746	0.679	12
265	300	265_I	300_Y	0.2863	0.746	0.679	35
310	314	310_A	314_Y	0.2859	0.745	0.677	4
392	395	392_A	395_K	0.2858	0.745	0.677	3
265	270	265_I	270_R	0.2857	0.744	0.676	5
599	611	599_F	611_S	0.2857	0.744	0.676	12
377	416	377_N	416_H	0.2856	0.744	0.676	39
541	566	541_A	566_L	0.2853	0.743	0.674	25
181	216	181_Y	216_A	0.2852	0.743	0.674	35
432	471	432_D	471_K	0.285	0.742	0.673	39
467	545	467_T	545_M	0.2848	0.742	0.673	78
425	429	425_K	429_L	0.2847	0.742	0.673	4
644	647	644_N	647_I	0.2845	0.741	0.671	3
241	272	241_K	272_D	0.2842	0.74	0.67	31
721	725	721_E	725_V	0.284	0.74	0.67	4
352	384	352_N	384_I	0.2828	0.737	0.665	32
177	189	177_I	189_V	0.2822	0.735	0.662	12
388	391	388_I	391_D	0.282	0.735	0.662	3
506	539	506_D	539_N	0.2819	0.734	0.66	33
722	749	722_S	749_T	0.2814	0.733	0.659	27
612	637	612_K	637_L	0.281	0.732	0.657	25
444	472	444_K	472_Q	0.2808	0.732	0.657	28
280	283	280_L	283_E	0.2804	0.731	0.656	3
654	666	654_E	666_Y	0.2799	0.729	0.653	12
762	765	762_S	765_Q	0.2798	0.729	0.653	3
449	466	449_E	466_Y	0.2798	0.729	0.653	17
275	278	275_Y	278_S	0.2797	0.729	0.653	3
605	609	605_P	609_K	0.2796	0.728	0.651	4
177	192	177_I	192_D	0.2791	0.727	0.65	15
763	767	763_L	767_L	0.2789	0.727	0.65	4
505	530	505_K	530_N	0.2789	0.727	0.65	25
237	264	237_I	264_Y	0.2788	0.726	0.648	27
281	297	281_D	297_Y	0.2788	0.726	0.648	16
714	719	714_T	719_N	0.2788	0.726	0.648	5
699	702	699_N	702_S	0.2784	0.725	0.647	3
762	766	762_S	766_C	0.2781	0.725	0.647	4
465	504	465_R	504_Y	0.2781	0.724	0.645	39
556	585	556_I	585_E	0.2779	0.724	0.645	29
572	597	572_V	597_I	0.2778	0.724	0.645	25
408	443	408_K	443_I	0.2777	0.724	0.645	35
353	357	353_T	357_A	0.2772	0.722	0.642	4
418	496	418_N	496_G	0.2772	0.722	0.642	78
540	544	540_A	544_F	0.2766	0.721	0.64	4
647	673	647_I	673_A	0.2764	0.72	0.639	26
608	642	608_I	642_D	0.2764	0.72	0.639	34
577	580	577_D	580_D	0.2763	0.72	0.639	3
504	508	504_Y	508_I	0.2762	0.72	0.639	4
747	759	747_A	759_E	0.2756	0.718	0.635	12
178	193	178_K	193_A	0.2754	0.718	0.635	15
730	742	730_L	742_A	0.2752	0.717	0.634	12
450	454	450_V	454_L	0.2752	0.717	0.634	4
618	626	618_R	626_N	0.2741	0.714	0.629	8
540	565	540_A	565_C	0.2738	0.713	0.627	25
210	243	210_I	243_W	0.2737	0.713	0.627	33
604	636	604_Y	636_S	0.2737	0.713	0.627	32
539	543	539_N	543_I	0.2735	0.713	0.627	4
529	544	529_K	544_F	0.2733	0.712	0.626	15
332	371	332_M	371_E	0.2732	0.712	0.626	39
397	619	397_S	619_I	0.273	0.711	0.624	222
674	686	674_N	686_A	0.2728	0.711	0.624	12
577	581	577_D	581_K	0.2726	0.71	0.623	4
272	276	272_D	276_T	0.2726	0.71	0.623	4
561	564	561_Q	564_A	0.272	0.709	0.621	3
294	320	294_K	320_N	0.2717	0.708	0.619	26
671	708	671_S	708_I	0.2717	0.708	0.619	37
546	550	546_R	550_Y	0.2716	0.708	0.619	4
573	576	573_E	576_L	0.2716	0.708	0.619	3
564	567	564_A	567_I	0.2716	0.708	0.619	3
203	209	203_S	209_F	0.2712	0.707	0.618	6
486	523	486_D	523_A	0.2707	0.705	0.615	37
537	565	537_C	565_C	0.2697	0.703	0.611	28
476	484	476_K	484_A	0.2693	0.702	0.61	8
580	598	580_D	598_L	0.2692	0.701	0.608	18
452	459	452_F	459_A	0.2689	0.701	0.608	7
356	394	356_K	394_A	0.2689	0.7	0.606	38
370	374	370_L	374_K	0.2689	0.7	0.606	4
398	620	398_K	620_L	0.2688	0.7	0.606	222
486	526	486_D	526_N	0.2684	0.699	0.605	40
714	726	714_T	726_L	0.2683	0.699	0.605	12
426	429	426_Y	429_L	0.2681	0.698	0.603	3
506	531	506_D	531_A	0.2677	0.697	0.601	25
493	498	493_Y	498_F	0.2676	0.697	0.601	5
218	233	218_N	233_L	0.2676	0.697	0.601	15
299	333	299_D	333_S	0.2676	0.697	0.601	34
722	726	722_S	726_L	0.2674	0.697	0.601	4
567	593	567_I	593_Q	0.2672	0.696	0.6	26
671	674	671_S	674_N	0.2669	0.695	0.598	3
191	194	191_I	194_Q	0.2663	0.694	0.596	3
316	320	316_N	320_N	0.2662	0.694	0.596	4
651	681	651_Q	681_T	0.266	0.693	0.595	30
673	685	673_A	685_Y	0.2658	0.693	0.595	12
607	611	607_V	611_S	0.2657	0.692	0.593	4
431	447	431_M	447_S	0.2651	0.691	0.592	16
684	687	684_T	687_P	0.2645	0.689	0.588	3
653	665	653_L	665_A	0.2644	0.689	0.588	12
370	406	370_L	406_T	0.2644	0.689	0.588	36
636	640	636_S	640_L	0.2643	0.688	0.587	4
299	303	299_D	303_N	0.2641	0.688	0.587	4
653	656	653_L	656_F	0.264	0.688	0.587	3
307	341	307_K	341_N	0.2639	0.688	0.587	34
593	632	593_Q	632_L	0.2633	0.686	0.583	39
592	596	592_L	596_S	0.2633	0.686	0.583	4
422	426	422_D	426_Y	0.2631	0.686	0.583	4
377	409	377_N	409_D	0.263	0.685	0.582	32
467	492	467_T	492_Y	0.263	0.685	0.582	25
211	259	211_L	259_I	0.2629	0.685	0.582	48
403	440	403_Y	440_L	0.2628	0.685	0.582	37
189	216	189_V	216_A	0.2624	0.684	0.58	27
271	275	271_A	275_Y	0.2623	0.683	0.578	4
302	333	302_Y	333_S	0.2615	0.681	0.575	31
654	665	654_E	665_A	0.2615	0.681	0.575	11
407	433	407_L	433_D	0.2613	0.681	0.575	26
544	611	544_F	611_S	0.2604	0.678	0.57	67
499	502	499_S	502_L	0.2603	0.678	0.57	3
493	526	493_Y	526_N	0.26	0.677	0.568	33
311	343	311_V	343_Q	0.2596	0.676	0.566	32
452	487	452_F	487_E	0.2594	0.676	0.566	35
315	346	315_E	346_K	0.2594	0.676	0.566	31
559	585	559_K	585_E	0.2593	0.676	0.566	26
194	235	194_Q	235_K	0.2592	0.675	0.565	41
412	415	412_L	415_S	0.2588	0.674	0.563	3
444	469	444_K	469_L	0.2586	0.674	0.563	25
239	242	239_D	242_N	0.2582	0.673	0.561	3
505	527	505_K	527_D	0.2578	0.672	0.56	22
584	616	584_N	616_N	0.2574	0.671	0.558	32
575	579	575_A	579_I	0.2574	0.671	0.558	4
719	749	719_N	749_T	0.2572	0.67	0.556	30
421	499	421_S	499_S	0.2569	0.669	0.555	78
385	413	385_S	413_V	0.2569	0.669	0.555	28
610	613	610_I	613_D	0.2568	0.669	0.555	3
683	713	683_L	713_L	0.2565	0.668	0.553	30
234	238	234_E	238_D	0.2561	0.667	0.551	4
579	590	579_I	590_Y	0.256	0.667	0.551	11
408	446	408_K	446_A	0.2557	0.666	0.549	38
547	550	547_F	550_Y	0.2553	0.665	0.548	3
426	504	426_Y	504_Y	0.2551	0.665	0.548	78
502	536	502_L	536_N	0.2546	0.663	0.544	34
371	409	371_E	409_D	0.2545	0.663	0.544	38
238	241	238_D	241_K	0.2543	0.663	0.544	3
258	296	258_H	296_D	0.254	0.662	0.543	38
526	529	526_N	529_K	0.2538	0.661	0.541	3
428	467	428_D	467_T	0.2537	0.661	0.541	39
270	303	270_R	303_N	0.2536	0.661	0.541	33
412	427	412_L	427_L	0.2534	0.66	0.539	15
614	617	614_I	617_S	0.2532	0.66	0.539	3
743	766	743_L	766_C	0.2531	0.66	0.539	23
567	597	567_I	597_I	0.253	0.659	0.538	30
644	648	644_N	648_K	0.2525	0.658	0.536	4
373	388	373_A	388_I	0.2525	0.658	0.536	15
243	246	243_W	246_T	0.2524	0.658	0.536	3
398	511	398_K	511_K	0.2522	0.657	0.534	113
576	603	576_L	603_Q	0.2522	0.657	0.534	27
726	730	726_L	730_L	0.2521	0.657	0.534	4
462	466	462_L	466_Y	0.2521	0.657	0.534	4
707	742	707_F	742_A	0.2519	0.656	0.532	35
394	432	394_A	432_D	0.2518	0.656	0.532	38
301	304	301_I	304_L	0.2518	0.656	0.532	3
428	506	428_D	506_D	0.2514	0.655	0.531	78
560	590	560_K	590_Y	0.2513	0.655	0.531	30
487	490	487_E	490_A	0.2511	0.654	0.529	3
610	614	610_I	614_I	0.2511	0.654	0.529	4
296	299	296_D	299_D	0.251	0.654	0.529	3
719	752	719_N	752_R	0.2505	0.653	0.527	33
176	179	176_R	179_K	0.2504	0.652	0.526	3
649	653	649_I	653_L	0.2503	0.652	0.526	4
425	503	425_K	503_A	0.2496	0.65	0.522	78
295	330	295_L	330_A	0.2495	0.65	0.522	35
186	216	186_Y	216_A	0.2493	0.649	0.52	30
764	767	764_K	767_L	0.2492	0.649	0.52	3
670	685	670_L	685_Y	0.2491	0.649	0.52	15
631	635	631_Y	635_L	0.2488	0.648	0.519	4
181	212	181_Y	212_Y	0.2487	0.648	0.519	31
339	344	339_L	344_V	0.2485	0.647	0.517	5
423	450	423_A	450_V	0.2483	0.647	0.517	27
740	766	740_A	766_C	0.2483	0.647	0.517	26
578	581	578_Y	581_K	0.2478	0.646	0.515	3
197	213	197_I	213_K	0.2473	0.644	0.512	16
331	357	331_A	357_A	0.2473	0.644	0.512	26
733	742	733_K	742_A	0.2472	0.644	0.512	9
612	651	612_K	651_Q	0.2471	0.644	0.512	39
460	499	460_S	499_S	0.247	0.643	0.51	39
588	618	588_I	618_R	0.2462	0.642	0.508	30
383	421	383_D	421_S	0.2462	0.641	0.507	38
524	550	524_A	550_Y	0.2459	0.641	0.507	26
377	415	377_N	415_S	0.2454	0.639	0.503	38
218	259	218_N	259_I	0.2453	0.639	0.503	41
643	675	643_Y	675_D	0.2452	0.639	0.503	32
578	582	578_Y	582_N	0.2452	0.639	0.503	4
374	389	374_K	389_Y	0.2449	0.638	0.502	15
690	705	690_I	705_L	0.2448	0.638	0.502	15
352	376	352_N	376_F	0.2447	0.638	0.502	24
196	199	196_A	199_R	0.2445	0.637	0.5	3
510	549	510_S	549_A	0.2444	0.637	0.5	39
464	542	464_Q	542_N	0.2442	0.636	0.498	78
459	495	459_A	495_E	0.2441	0.636	0.498	36
388	504	388_I	504_Y	0.244	0.636	0.498	116
714	752	714_T	752_R	0.2438	0.635	0.496	38
538	573	538_I	573_E	0.2436	0.635	0.496	35
748	751	748_L	751_E	0.2435	0.634	0.495	3
711	715	711_D	715_K	0.2435	0.634	0.495	4
318	334	318_Y	334_L	0.2433	0.634	0.495	16
501	530	501_I	530_N	0.2431	0.633	0.493	29
396	403	396_M	403_Y	0.2429	0.633	0.493	7
589	593	589_F	593_Q	0.2423	0.631	0.49	4
572	600	572_V	600_D	0.2421	0.631	0.49	28
535	570	535_D	570_S	0.2415	0.629	0.486	35
339	371	339_L	371_E	0.2413	0.629	0.486	32
723	755	723_L	755_N	0.2413	0.629	0.486	32
178	208	178_K	208_E	0.2409	0.628	0.484	30
720	724	720_E	724_A	0.2409	0.628	0.484	4
415	493	415_S	493_Y	0.2404	0.626	0.481	78
356	549	356_K	549_A	0.2403	0.626	0.481	193
307	340	307_K	340_S	0.2402	0.626	0.481	33
507	513	507_L	513_I	0.2402	0.626	0.481	6
506	543	506_D	543_I	0.2402	0.626	0.481	37
386	419	386_A	419_R	0.2401	0.625	0.479	33
643	672	643_Y	672_Y	0.2399	0.625	0.479	29
366	392	366_I	392_A	0.2396	0.624	0.478	26
264	267	264_Y	267_L	0.2393	0.624	0.478	3
708	711	708_I	711_D	0.2393	0.624	0.478	3
192	195	192_D	195_N	0.2386	0.622	0.474	3
262	266	262_R	266_A	0.2385	0.621	0.472	4
520	523	520_L	523_A	0.2383	0.621	0.472	3
426	465	426_Y	465_R	0.2382	0.621	0.472	39
490	493	490_A	493_Y	0.2379	0.62	0.471	3
503	506	503_A	506_D	0.2376	0.619	0.469	3
543	547	543_I	547_F	0.2376	0.619	0.469	4
385	389	385_S	389_Y	0.2376	0.619	0.469	4
565	569	565_C	569_T	0.2375	0.619	0.469	4
348	381	348_I	381_Q	0.2374	0.619	0.469	33
384	388	384_I	388_I	0.2372	0.618	0.467	4
499	538	499_S	538_I	0.2372	0.618	0.467	39
631	668	631_Y	668_A	0.2371	0.618	0.467	37
611	636	611_S	636_S	0.237	0.618	0.467	25
344	379	344_V	379_K	0.2369	0.617	0.466	35
178	212	178_K	212_Y	0.2367	0.617	0.466	34
356	432	356_K	432_D	0.2366	0.616	0.464	76
545	580	545_M	580_D	0.2362	0.615	0.462	35
691	695	691_D	695_F	0.2362	0.615	0.462	4
532	537	532_I	537_C	0.2361	0.615	0.462	5
351	505	351_I	505_K	0.236	0.615	0.462	154
511	620	511_K	620_L	0.2357	0.614	0.46	109
505	509	505_K	509_E	0.2357	0.614	0.46	4
426	578	426_Y	578_Y	0.2356	0.614	0.46	152
758	762	758_A	762_S	0.2356	0.614	0.46	4
440	443	440_L	443_I	0.2356	0.614	0.46	3
333	336	333_S	336_K	0.2353	0.613	0.459	3
214	239	214_L	239_D	0.2352	0.613	0.459	25
596	599	596_S	599_F	0.235	0.612	0.457	3
532	565	532_I	565_C	0.235	0.612	0.457	33
504	543	504_Y	543_I	0.2349	0.612	0.457	39
544	558	544_F	558_N	0.2346	0.611	0.455	14
339	378	339_L	378_Q	0.2346	0.611	0.455	39
328	331	328_A	331_A	0.2345	0.611	0.455	3
189	193	189_V	193_A	0.2344	0.611	0.455	4
407	485	407_L	485_L	0.2344	0.611	0.455	78
346	350	346_K	350_Y	0.2344	0.611	0.455	4
259	262	259_I	262_R	0.234	0.61	0.454	3
541	571	541_A	571_N	0.2339	0.609	0.452	30
725	729	725_V	729_L	0.2339	0.609	0.452	4
393	410	393_F	410_L	0.2338	0.609	0.452	17
486	508	486_D	508_I	0.2336	0.609	0.452	22
719	723	719_N	723_L	0.2336	0.609	0.452	4
510	616	510_S	616_N	0.2335	0.608	0.45	106
302	310	302_Y	310_A	0.2334	0.608	0.45	8
645	649	645_Q	649_I	0.2329	0.607	0.449	4
425	464	425_K	464_Q	0.2328	0.606	0.447	39
383	387	383_D	387_S	0.2327	0.606	0.447	4
605	644	605_P	644_N	0.2325	0.606	0.447	39
244	260	244_T	260_M	0.2321	0.605	0.445	16
727	750	727_T	750_Y	0.2319	0.604	0.443	23
409	412	409_D	412_L	0.2318	0.604	0.443	3
651	673	651_Q	673_A	0.2317	0.604	0.443	22
468	507	468_D	507_L	0.2315	0.603	0.442	39
336	339	336_K	339_L	0.2314	0.603	0.442	3
278	309	278_S	309_K	0.2313	0.603	0.442	31
302	340	302_Y	340_S	0.2309	0.602	0.44	38
295	299	295_L	299_D	0.2307	0.601	0.438	4
567	600	567_I	600_D	0.2304	0.6	0.437	33
425	428	425_K	428_D	0.2304	0.6	0.437	3
532	599	532_I	599_F	0.2303	0.6	0.437	67
549	616	549_A	616_N	0.2302	0.6	0.437	67
278	301	278_S	301_I	0.2302	0.6	0.437	23
525	558	525_I	558_N	0.2301	0.599	0.435	33
759	763	759_E	763_L	0.2299	0.599	0.435	4
671	686	671_S	686_A	0.2298	0.599	0.435	15
503	542	503_A	542_N	0.2297	0.598	0.433	39
327	330	327_A	330_A	0.2297	0.598	0.433	3
745	748	745_I	748_L	0.2294	0.598	0.433	3
382	420	382_F	420_S	0.2293	0.597	0.432	38
330	333	330_A	333_S	0.2291	0.597	0.432	3
504	610	504_Y	610_I	0.2291	0.597	0.432	106
524	559	524_A	559_K	0.229	0.597	0.432	35
663	689	663_V	689_A	0.229	0.597	0.432	26
485	513	485_L	513_I	0.229	0.597	0.432	28
635	638	635_L	638_L	0.2288	0.596	0.43	3
451	454	451_F	454_L	0.2287	0.596	0.43	3
463	541	463_H	541_A	0.2286	0.596	0.43	78
308	312	308_E	312_N	0.2283	0.595	0.428	4
596	600	596_S	600_D	0.2283	0.595	0.428	4
261	273	261_L	273_V	0.2283	0.595	0.428	12
560	582	560_K	582_N	0.2281	0.594	0.427	22
446	449	446_A	449_E	0.2279	0.594	0.427	3
635	668	635_L	668_A	0.2276	0.593	0.425	33
352	355	352_N	355_L	0.2273	0.592	0.423	3
314	337	314_Y	337_N	0.2272	0.592	0.423	23