i	j	i_id	j_id	r_sco	s_sco	prob	distance
613	616	613_L	616_Q	1.404	4.525	1	3
759	762	759_N	762_S	1.3914	4.484	1	3
263	266	263_Y	266_E	1.3704	4.416	1	3
514	517	514_N	517_L	1.3572	4.374	1	3
480	483	480_K	483_L	1.3244	4.268	1	3
359	362	359_N	362_D	1.3172	4.245	1	3
325	328	325_E	328_K	1.3113	4.226	1	3
192	195	192_K	195_E	1.2944	4.171	1	3
724	727	724_Q	727_E	1.2905	4.159	1	3
793	796	793_N	796_A	1.263	4.07	1	3
448	451	448_D	451_D	1.2242	3.945	1	3
296	299	296_F	299_K	1.224	3.944	1	3
549	552	549_D	552_K	1.2157	3.918	1	3
160	163	160_E	163_Q	1.1139	3.59	1	3
226	229	226_D	229_K	1.1136	3.589	1	3
689	692	689_L	692_L	1.039	3.348	1	3
506	522	506_A	522_F	0.7829	2.523	1	16
351	367	351_T	367_L	0.7697	2.48	1	16
472	488	472_I	488_F	0.751	2.42	1	16
604	621	604_E	621_I	0.7435	2.396	1	17
716	732	716_A	732_Y	0.7348	2.368	1	16
440	456	440_A	456_L	0.7225	2.328	1	16
255	271	255_S	271_L	0.6856	2.21	1	16
502	521	502_H	521_H	0.6755	2.177	1	19
251	270	251_D	270_M	0.6446	2.077	1	19
288	304	288_A	304_L	0.6382	2.057	1	16
184	200	184_G	200_F	0.6356	2.048	1	16
489	505	489_Q	505_L	0.6356	2.048	1	16
272	287	272_Q	287_S	0.6334	2.041	1	15
607	616	607_V	616_Q	0.6203	1.999	1	9
457	471	457_N	471_N	0.6086	1.961	1	14
317	333	317_G	333_L	0.6058	1.952	1	16
258	266	258_N	266_E	0.6057	1.952	1	8
334	350	334_S	350_L	0.6043	1.947	1	16
313	332	313_S	332_A	0.6006	1.935	1	19
573	603	573_K	603_F	0.5969	1.924	1	30
475	483	475_Y	483_L	0.5907	1.904	1	8
751	767	751_A	767_L	0.5906	1.903	1	16
350	354	350_L	354_D	0.5893	1.899	1	4
471	487	471_N	487_E	0.5856	1.887	1	16
254	258	254_L	258_N	0.5833	1.88	1	4
747	766	747_L	766_L	0.5828	1.878	1	19
320	328	320_Y	328_K	0.5816	1.874	1	8
754	762	754_A	762_S	0.5783	1.864	1	8
712	731	712_L	731_L	0.5737	1.849	1	19
330	350	330_K	350_L	0.5705	1.838	1	20
523	540	523_S	540_M	0.57	1.837	1	17
180	199	180_N	199_S	0.5644	1.819	1	19
291	299	291_Y	299_K	0.5631	1.815	1	8
623	626	623_K	626_S	0.5611	1.808	1	3
509	517	509_Y	517_L	0.5609	1.808	1	8
354	362	354_D	362_D	0.56	1.805	1	8
505	521	505_L	521_H	0.557	1.795	1	16
750	766	750_A	766_L	0.5549	1.788	1	16
468	487	468_K	487_E	0.5539	1.785	1	19
600	620	600_S	620_K	0.5534	1.783	1	20
347	366	347_L	366_R	0.5531	1.783	1	19
729	733	729_Y	733_N	0.5527	1.781	1	4
471	475	471_N	475_Y	0.5519	1.779	1	4
781	800	781_K	800_Q	0.5516	1.778	1	19
733	750	733_N	750_A	0.5498	1.772	1	17
330	334	330_K	334_S	0.5471	1.763	1	4
715	719	715_L	719_D	0.5395	1.739	0.999	4
754	759	754_A	759_N	0.5394	1.738	0.999	5
729	753	729_Y	753_A	0.5349	1.724	0.999	24
618	622	618_D	622_A	0.5347	1.723	0.999	4
305	316	305_N	316_L	0.5314	1.713	0.999	11
316	332	316_L	332_A	0.5295	1.706	0.999	16
187	195	187_Q	195_E	0.5294	1.706	0.999	8
169	183	169_E	183_L	0.5256	1.694	0.999	14
699	702	699_E	702_N	0.5253	1.693	0.999	3
268	272	268_L	272_Q	0.5249	1.691	0.999	4
541	572	541_F	572_Q	0.5231	1.686	0.999	31
734	737	734_S	737_D	0.5179	1.669	0.999	3
333	349	333_L	349_A	0.5179	1.669	0.999	16
785	801	785_G	801_Y	0.5158	1.662	0.999	16
603	620	603_F	620_K	0.5153	1.661	0.999	17
482	512	482_R	512_M	0.5146	1.659	0.999	30
740	743	740_G	743_D	0.5143	1.658	0.999	3
183	187	183_L	187_Q	0.5139	1.656	0.999	4
284	303	284_K	303_Q	0.5095	1.642	0.999	19
168	182	168_Y	182_N	0.5074	1.635	0.999	14
485	508	485_N	508_T	0.5064	1.632	0.999	23
183	199	183_L	199_S	0.5052	1.628	0.999	16
152	168	152_A	168_Y	0.5034	1.622	0.999	16
762	765	762_S	765_A	0.5034	1.622	0.999	3
254	270	254_L	270_M	0.5032	1.622	0.999	16
729	757	729_Y	757_A	0.5014	1.616	0.999	28
443	451	443_T	451_D	0.4961	1.599	0.999	8
784	788	784_L	788_Y	0.4957	1.597	0.999	4
750	754	750_A	754_A	0.4956	1.597	0.999	4
335	338	335_T	338_K	0.494	1.592	0.999	3
271	286	271_L	286_L	0.4936	1.591	0.999	15
485	505	485_N	505_L	0.4928	1.588	0.999	20
540	544	540_M	544_K	0.4919	1.585	0.999	4
301	305	301_I	305_N	0.4909	1.582	0.998	4
727	730	727_E	730_A	0.4907	1.581	0.998	3
151	155	151_K	155_L	0.4898	1.578	0.998	4
200	216	200_F	216_N	0.4876	1.571	0.998	16
769	772	769_L	772_L	0.4872	1.57	0.998	3
439	443	439_K	443_T	0.487	1.57	0.998	4
719	727	719_D	727_E	0.4838	1.559	0.998	8
316	320	316_L	320_Y	0.4835	1.558	0.998	4
715	731	715_L	731_L	0.4833	1.558	0.998	16
788	796	788_Y	796_A	0.4819	1.553	0.998	8
698	715	698_K	715_L	0.4815	1.552	0.998	17
697	714	697_I	714_T	0.4795	1.545	0.998	17
694	698	694_R	698_K	0.4792	1.544	0.998	4
202	205	202_K	205_A	0.4769	1.537	0.998	3
258	263	258_N	263_Y	0.4751	1.531	0.998	5
197	217	197_F	217_A	0.4739	1.527	0.998	20
287	303	287_S	303_Q	0.473	1.524	0.998	16
330	353	330_K	353_V	0.4719	1.521	0.998	23
328	331	328_K	331_V	0.4718	1.52	0.998	3
218	234	218_A	234_I	0.4714	1.519	0.998	16
768	784	768_Q	784_L	0.4708	1.517	0.998	16
327	357	327_A	357_T	0.4706	1.517	0.998	30
726	757	726_E	757_A	0.4685	1.51	0.998	31
764	768	764_I	768_Q	0.4681	1.509	0.997	4
187	192	187_Q	192_K	0.4659	1.501	0.997	5
201	217	201_K	217_A	0.4653	1.499	0.997	16
544	552	544_K	552_K	0.4647	1.497	0.997	8
719	724	719_D	724_Q	0.4633	1.493	0.997	5
364	368	364_L	368_Q	0.4627	1.491	0.997	4
485	489	485_N	489_Q	0.458	1.476	0.997	4
217	221	217_A	221_A	0.4571	1.473	0.997	4
524	527	524_S	527_H	0.457	1.473	0.997	3
268	287	268_L	287_S	0.4561	1.47	0.997	19
350	366	350_L	366_R	0.4527	1.459	0.996	16
764	787	764_I	787_L	0.4513	1.454	0.996	23
475	487	475_Y	487_E	0.4502	1.451	0.996	12
607	620	607_V	620_K	0.4483	1.445	0.996	13
436	455	436_Y	455_Y	0.4471	1.441	0.996	19
505	509	505_L	509_Y	0.4429	1.427	0.996	4
732	749	732_Y	749_L	0.4407	1.42	0.995	17
603	607	603_F	607_V	0.4405	1.42	0.995	4
488	504	488_F	504_N	0.4392	1.415	0.995	16
396	399	396_N	399_V	0.4349	1.402	0.995	3
622	638	622_A	638_Y	0.4346	1.4	0.995	16
320	332	320_Y	332_A	0.4345	1.4	0.995	12
163	166	163_Q	166_K	0.4337	1.398	0.995	3
217	233	217_A	233_Y	0.4329	1.395	0.995	16
439	455	439_K	455_Y	0.4324	1.393	0.994	16
519	523	519_Y	523_S	0.4308	1.388	0.994	4
453	457	453_G	457_N	0.4304	1.387	0.994	4
197	201	197_F	201_K	0.4303	1.387	0.994	4
165	169	165_L	169_E	0.4281	1.38	0.994	4
490	493	490_K	493_K	0.4281	1.38	0.994	3
483	486	483_L	486_Q	0.4279	1.379	0.994	3
197	220	197_F	220_C	0.4277	1.378	0.994	23
785	804	785_G	804_L	0.4264	1.374	0.994	19
761	791	761_N	791_V	0.4261	1.373	0.994	30
694	718	694_R	718_L	0.4258	1.372	0.994	24
509	521	509_Y	521_H	0.4256	1.372	0.994	12
255	274	255_S	274_T	0.4256	1.372	0.994	19
287	291	287_S	291_Y	0.4246	1.368	0.993	4
330	357	330_K	357_T	0.4245	1.368	0.993	27
354	366	354_D	366_R	0.4245	1.368	0.993	12
258	270	258_N	270_M	0.4238	1.366	0.993	12
509	514	509_Y	514_N	0.4234	1.365	0.993	5
291	296	291_Y	296_F	0.4233	1.364	0.993	5
643	646	643_N	646_L	0.4222	1.361	0.993	3
796	799	796_A	799_S	0.4204	1.355	0.993	3
351	370	351_T	370_S	0.4202	1.354	0.993	19
266	269	266_E	269_Q	0.4202	1.354	0.993	3
522	539	522_F	539_A	0.42	1.353	0.993	17
221	229	221_A	229_K	0.4146	1.336	0.992	8
729	750	729_Y	750_A	0.4143	1.335	0.992	21
299	302	299_K	302_Q	0.4142	1.335	0.992	3
165	183	165_L	183_L	0.4138	1.334	0.992	18
456	470	456_L	470_A	0.4125	1.329	0.991	14
713	749	713_Q	749_L	0.412	1.328	0.991	36
574	577	574_S	577_F	0.4102	1.322	0.991	3
485	509	485_N	509_Y	0.41	1.321	0.991	24
184	203	184_G	203_A	0.4096	1.32	0.991	19
317	336	317_G	336_A	0.4093	1.319	0.991	19
704	707	704_S	707_K	0.4085	1.317	0.991	3
231	235	231_R	235_D	0.4075	1.313	0.99	4
343	346	343_F	346_S	0.4055	1.307	0.99	3
344	370	344_N	370_S	0.4047	1.304	0.99	26
784	800	784_L	800_Q	0.4043	1.303	0.99	16
330	354	330_K	354_D	0.4033	1.3	0.99	24
698	727	698_K	727_E	0.4028	1.298	0.989	29
148	167	148_M	167_V	0.4005	1.291	0.989	19
195	198	195_E	198_E	0.4005	1.291	0.989	3
519	540	519_Y	540_M	0.3997	1.288	0.989	21
268	290	268_L	290_I	0.3987	1.285	0.988	22
485	512	485_N	512_M	0.3964	1.277	0.988	27
764	784	764_I	784_L	0.3963	1.277	0.988	20
684	692	684_M	692_L	0.3963	1.277	0.988	8
510	522	510_A	522_F	0.3961	1.276	0.988	12
354	359	354_D	359_N	0.3959	1.276	0.988	5
170	173	170_Q	173_V	0.3957	1.275	0.988	3
517	520	517_L	520_K	0.3944	1.271	0.987	3
277	280	277_E	280_S	0.3941	1.27	0.987	3
751	770	751_A	770_S	0.3934	1.268	0.987	19
735	746	735_L	746_T	0.3928	1.266	0.987	11
736	747	736_I	747_L	0.3927	1.266	0.987	11
607	613	607_V	613_L	0.3922	1.264	0.987	6
347	369	347_L	369_N	0.3916	1.262	0.987	22
188	200	188_M	200_F	0.3915	1.262	0.987	12
628	631	628_L	631_D	0.3895	1.255	0.986	3
369	372	369_N	372_D	0.3894	1.255	0.986	3
748	783	748_F	783_A	0.389	1.254	0.986	35
155	163	155_L	163_Q	0.3888	1.253	0.986	8
337	347	337_M	347_L	0.3886	1.252	0.986	10
235	254	235_D	254_L	0.3879	1.25	0.985	19
231	254	231_R	254_L	0.387	1.247	0.985	23
187	199	187_Q	199_S	0.3864	1.245	0.985	12
362	365	362_D	365_A	0.3862	1.244	0.985	3
692	695	692_L	695_Q	0.3861	1.244	0.985	3
733	737	733_N	737_D	0.386	1.244	0.985	4
788	793	788_Y	793_N	0.3853	1.242	0.985	5
569	573	569_A	573_K	0.3839	1.237	0.984	4
291	303	291_Y	303_Q	0.383	1.234	0.984	12
709	735	709_E	735_L	0.3825	1.233	0.984	26
502	524	502_H	524_S	0.3814	1.229	0.983	22
476	488	476_A	488_F	0.3811	1.228	0.983	12
214	233	214_A	233_Y	0.3801	1.225	0.983	19
301	319	301_I	319_L	0.38	1.224	0.983	18
265	294	265_P	294_M	0.3796	1.223	0.982	29
764	791	764_I	791_V	0.3789	1.221	0.982	27
472	491	472_I	491_L	0.3774	1.216	0.982	19
443	448	443_T	448_D	0.3772	1.216	0.982	5
699	703	699_E	703_V	0.3764	1.213	0.981	4
469	504	469_I	504_N	0.3759	1.211	0.981	35
453	474	453_G	474_N	0.3758	1.211	0.981	21
475	480	475_Y	480_K	0.3757	1.211	0.981	5
251	273	251_D	273_R	0.3755	1.21	0.981	22
503	539	503_Y	539_A	0.3746	1.207	0.98	36
321	333	321_A	333_L	0.3741	1.206	0.98	12
443	455	443_T	455_Y	0.3738	1.205	0.98	12
337	346	337_M	346_S	0.3721	1.199	0.979	9
334	338	334_S	338_K	0.3697	1.191	0.978	4
712	734	712_L	734_S	0.3696	1.191	0.978	22
523	527	523_S	527_H	0.3694	1.19	0.978	4
569	603	569_A	603_F	0.3693	1.19	0.978	34
453	471	453_G	471_N	0.3691	1.19	0.978	18
532	535	532_N	535_A	0.3681	1.186	0.977	3
716	735	716_A	735_L	0.3664	1.181	0.977	19
194	224	194_Q	224_L	0.3658	1.179	0.976	30
153	168	153_N	168_Y	0.3649	1.176	0.976	15
301	316	301_I	316_L	0.3641	1.173	0.975	15
320	325	320_Y	325_E	0.3639	1.173	0.975	5
177	203	177_S	203_A	0.3633	1.171	0.975	26
229	232	229_K	232_Y	0.363	1.17	0.975	3
453	478	453_G	478_N	0.3629	1.17	0.975	25
694	715	694_R	715_L	0.3621	1.167	0.974	21
524	528	524_S	528_L	0.3621	1.167	0.974	4
569	606	569_A	606_I	0.362	1.167	0.974	37
368	372	368_Q	372_D	0.3618	1.166	0.974	4
221	226	221_A	226_D	0.3605	1.162	0.974	5
680	684	680_Y	684_M	0.3602	1.161	0.973	4
572	602	572_Q	602_I	0.36	1.16	0.973	30
506	525	506_A	525_S	0.3597	1.159	0.973	19
769	773	769_L	773_T	0.3593	1.158	0.973	4
785	800	785_G	800_Q	0.3589	1.157	0.973	15
268	294	268_L	294_M	0.3589	1.157	0.973	26
544	549	544_K	549_D	0.3588	1.156	0.972	5
492	501	492_I	501_L	0.3578	1.153	0.972	9
782	786	782_A	786_M	0.3562	1.148	0.971	4
519	543	519_Y	543_A	0.3561	1.147	0.971	24
162	190	162_E	190_E	0.3557	1.146	0.971	28
736	746	736_I	746_T	0.3556	1.146	0.971	10
755	767	755_I	767_L	0.3554	1.145	0.97	12
743	746	743_D	746_T	0.3542	1.141	0.97	3
437	470	437_I	470_A	0.3536	1.14	0.969	33
616	619	616_Q	619_V	0.3535	1.139	0.969	3
798	802	798_I	802_K	0.353	1.138	0.969	4
789	801	789_Q	801_Y	0.3529	1.137	0.969	12
492	502	492_I	502_H	0.3527	1.137	0.969	10
516	547	516_E	547_D	0.3527	1.136	0.969	31
451	454	451_D	454_V	0.3517	1.133	0.968	3
495	498	495_Y	498_H	0.351	1.131	0.967	3
768	796	768_Q	796_A	0.3508	1.131	0.967	28
369	373	369_N	373_N	0.3492	1.125	0.966	4
248	274	248_K	274_T	0.3483	1.122	0.965	26
336	346	336_A	346_S	0.3482	1.122	0.965	10
204	214	204_I	214_A	0.3466	1.117	0.964	10
155	160	155_L	160_E	0.3458	1.114	0.964	5
622	626	622_A	626_S	0.3451	1.112	0.963	4
754	766	754_A	766_L	0.3442	1.109	0.962	12
221	233	221_A	233_Y	0.344	1.109	0.962	12
506	521	506_A	521_H	0.3432	1.106	0.962	15
453	475	453_G	475_Y	0.3429	1.105	0.961	22
255	267	255_S	267_A	0.3425	1.104	0.961	12
288	307	288_A	307_Q	0.3424	1.103	0.961	19
326	353	326_Y	353_V	0.342	1.102	0.961	27
733	762	733_N	762_S	0.3413	1.1	0.96	29
623	627	623_K	627_E	0.3409	1.099	0.96	4
605	621	605_A	621_I	0.3403	1.097	0.959	16
618	638	618_D	638_Y	0.3368	1.085	0.956	20
729	754	729_Y	754_A	0.3368	1.085	0.956	25
717	749	717_Y	749_L	0.3367	1.085	0.956	32
540	571	540_M	571_M	0.336	1.083	0.955	31
717	732	717_Y	732_Y	0.3358	1.082	0.955	15
165	190	165_L	190_E	0.3357	1.082	0.955	25
386	390	386_I	390_L	0.3353	1.081	0.955	4
202	206	202_K	206_N	0.3333	1.074	0.953	4
201	205	201_K	205_A	0.333	1.073	0.952	4
700	711	700_L	711_I	0.3324	1.071	0.952	11
155	167	155_L	167_V	0.3321	1.07	0.951	12
698	702	698_K	702_N	0.3321	1.07	0.951	4
468	490	468_K	490_K	0.332	1.07	0.951	22
329	353	329_A	353_V	0.3307	1.066	0.95	24
752	767	752_V	767_L	0.3302	1.064	0.949	15
450	478	450_A	478_N	0.3298	1.063	0.949	28
575	599	575_M	599_L	0.3297	1.063	0.949	24
207	210	207_G	210_Q	0.3297	1.062	0.949	3
310	336	310_F	336_A	0.3289	1.06	0.948	26
304	315	304_L	315_S	0.3285	1.059	0.948	11
751	766	751_A	766_L	0.3285	1.059	0.948	15
334	362	334_S	362_D	0.3281	1.057	0.947	28
506	518	506_A	518_A	0.3281	1.057	0.947	12
700	703	700_L	703_V	0.328	1.057	0.947	3
165	186	165_L	186_S	0.3278	1.056	0.947	21
575	578	575_M	578_L	0.3271	1.054	0.946	3
458	461	458_T	461_A	0.3267	1.053	0.946	3
770	780	770_S	780_S	0.3263	1.052	0.945	10
444	456	444_D	456_L	0.3263	1.052	0.945	12
767	783	767_L	783_A	0.3263	1.051	0.945	16
519	544	519_Y	544_K	0.3259	1.05	0.945	25
537	571	537_A	571_M	0.3256	1.049	0.944	34
788	800	788_Y	800_Q	0.3252	1.048	0.944	12
621	637	621_I	637_L	0.3247	1.046	0.943	16
268	291	268_L	291_Y	0.3247	1.046	0.943	23
234	253	234_I	253_Y	0.3246	1.046	0.943	19
768	772	768_Q	772_L	0.3244	1.045	0.943	4
774	777	774_D	777_N	0.3241	1.044	0.942	3
519	547	519_Y	547_D	0.3228	1.04	0.941	28
765	769	765_A	769_L	0.322	1.038	0.94	4
753	757	753_A	757_A	0.3218	1.037	0.94	4
166	170	166_K	170_Q	0.3216	1.037	0.94	4
184	199	184_G	199_S	0.3215	1.036	0.939	15
197	224	197_F	224_L	0.321	1.035	0.939	27
298	323	298_S	323_I	0.3202	1.032	0.938	25
625	635	625_R	635_N	0.3191	1.028	0.936	10
167	171	167_V	171_V	0.3186	1.027	0.936	4
701	712	701_I	712_L	0.3185	1.026	0.935	11
152	171	152_A	171_V	0.3177	1.024	0.934	19
573	577	573_K	577_F	0.3176	1.024	0.934	4
624	634	624_L	634_A	0.316	1.018	0.932	10
151	167	151_K	167_V	0.3147	1.014	0.93	16
156	168	156_Y	168_Y	0.3143	1.013	0.93	12
720	753	720_I	753_A	0.3141	1.012	0.929	33
472	487	472_I	487_E	0.3137	1.011	0.929	15
719	731	719_D	731_L	0.3136	1.011	0.929	12
576	600	576_L	600_S	0.3135	1.01	0.928	24
314	343	314_L	343_F	0.3134	1.01	0.928	29
440	459	440_A	459_S	0.3133	1.01	0.928	19
284	306	284_K	306_S	0.3131	1.009	0.928	22
725	753	725_Y	753_A	0.3093	0.997	0.922	28
491	494	491_L	494_D	0.3091	0.996	0.922	3
314	349	314_L	349_A	0.3089	0.995	0.921	35
624	627	624_L	627_E	0.308	0.993	0.92	3
787	791	787_L	791_V	0.3076	0.991	0.919	4
747	769	747_L	769_L	0.3073	0.99	0.919	22
280	283	280_S	283_A	0.3068	0.989	0.918	3
290	294	290_I	294_M	0.3066	0.988	0.918	4
355	367	355_I	367_L	0.3059	0.986	0.917	12
220	224	220_C	224_L	0.3055	0.985	0.916	4
270	274	270_M	274_T	0.3051	0.983	0.915	4
498	501	498_H	501_L	0.3043	0.981	0.914	3
734	739	734_S	739_Y	0.3042	0.98	0.913	5
486	490	486_Q	490_K	0.3042	0.98	0.913	4
334	354	334_S	354_D	0.3042	0.98	0.913	20
288	300	288_A	300_A	0.3034	0.978	0.912	12
551	611	551_T	611_N	0.3028	0.976	0.911	60
576	599	576_L	599_L	0.3023	0.974	0.91	23
771	781	771_K	781_K	0.3017	0.972	0.909	10
171	179	171_V	179_S	0.3014	0.971	0.908	8
771	780	771_K	780_S	0.3003	0.968	0.907	9
574	578	574_S	578_L	0.2996	0.966	0.905	4
457	461	457_N	461_A	0.2993	0.965	0.905	4
340	343	340_E	343_F	0.2992	0.964	0.904	3
165	187	165_L	187_Q	0.299	0.964	0.904	22
145	171	145_I	171_V	0.299	0.963	0.904	26
617	621	617_V	621_I	0.2988	0.963	0.904	4
691	722	691_N	722_A	0.2984	0.962	0.903	31
164	168	164_A	168_Y	0.2983	0.961	0.902	4
352	367	352_L	367_L	0.2979	0.96	0.902	15
552	570	552_K	570_N	0.2976	0.959	0.901	18
518	522	518_A	522_F	0.2973	0.958	0.901	4
257	261	257_I	261_K	0.2972	0.958	0.901	4
744	770	744_T	770_S	0.2971	0.957	0.9	26
203	213	203_A	213_A	0.2966	0.956	0.899	10
170	174	170_Q	174_Y	0.2962	0.955	0.899	4
786	801	786_M	801_Y	0.2957	0.953	0.897	15
319	323	319_L	323_I	0.2955	0.952	0.897	4
317	332	317_G	332_A	0.2951	0.951	0.896	15
228	261	228_E	261_K	0.2949	0.95	0.896	33
251	274	251_D	274_T	0.2949	0.95	0.896	23
491	501	491_L	501_L	0.2948	0.95	0.896	10
684	689	684_M	689_L	0.2948	0.95	0.896	5
252	286	252_Y	286_L	0.2947	0.95	0.896	34
631	634	631_D	634_A	0.2946	0.949	0.895	3
767	787	767_L	787_L	0.294	0.948	0.894	20
642	647	642_L	647_N	0.294	0.947	0.894	5
482	486	482_R	486_Q	0.2938	0.947	0.894	4
713	717	713_Q	717_Y	0.2936	0.946	0.893	4
259	271	259_Y	271_L	0.2931	0.945	0.892	12
351	363	351_T	363_M	0.2929	0.944	0.892	12
526	537	526_Y	537_A	0.2928	0.944	0.892	11
184	196	184_G	196_A	0.2924	0.942	0.89	12
365	369	365_A	369_N	0.2923	0.942	0.89	4
472	484	472_I	484_A	0.2922	0.942	0.89	12
597	624	597_T	624_L	0.2918	0.94	0.889	27
716	728	716_A	728_A	0.2912	0.938	0.888	12
309	312	309_N	312_S	0.2908	0.937	0.887	3
436	458	436_Y	458_T	0.2907	0.937	0.887	22
460	468	460_K	468_K	0.2905	0.936	0.886	8
701	711	701_I	711_I	0.2892	0.932	0.883	10
259	264	259_Y	264_Y	0.2891	0.932	0.883	5
484	488	484_A	488_F	0.2891	0.932	0.883	4
529	532	529_N	532_N	0.2883	0.929	0.881	3
321	353	321_A	353_V	0.2883	0.929	0.881	32
185	200	185_V	200_F	0.2879	0.928	0.881	15
785	797	785_G	797_A	0.2873	0.926	0.879	12
764	788	764_I	788_Y	0.2871	0.925	0.878	24
301	323	301_I	323_I	0.2865	0.923	0.877	22
492	505	492_I	505_L	0.2861	0.922	0.876	13
538	602	538_F	602_I	0.2861	0.922	0.876	64
615	619	615_N	619_V	0.2857	0.921	0.875	4
521	524	521_H	524_S	0.2851	0.919	0.874	3
638	696	638_Y	696_K	0.285	0.919	0.874	58
716	731	716_A	731_L	0.2844	0.916	0.872	15
731	735	731_L	735_L	0.2844	0.916	0.872	4
781	803	781_K	803_T	0.284	0.915	0.871	22
313	335	313_S	335_T	0.284	0.915	0.871	22
256	271	256_L	271_L	0.2838	0.915	0.871	15
489	493	489_Q	493_K	0.2837	0.914	0.87	4
235	239	235_D	239_V	0.283	0.912	0.869	4
273	276	273_R	276_M	0.2822	0.909	0.866	3
181	185	181_Y	185_V	0.2819	0.908	0.865	4
255	270	255_S	270_M	0.2815	0.907	0.865	15
308	312	308_G	312_S	0.2802	0.903	0.861	4
307	312	307_Q	312_S	0.2802	0.903	0.861	5
196	200	196_A	200_F	0.2801	0.903	0.861	4
520	524	520_K	524_S	0.2797	0.902	0.86	4
718	722	718_L	722_A	0.2789	0.899	0.858	4
238	251	238_Q	251_D	0.2779	0.896	0.855	13
604	624	604_E	624_L	0.2776	0.894	0.854	20
197	221	197_F	221_A	0.2773	0.894	0.854	24
625	634	625_R	634_A	0.2764	0.891	0.851	9
473	504	473_I	504_N	0.2761	0.89	0.85	31
274	283	274_T	283_A	0.2757	0.889	0.849	9
751	763	751_A	763_A	0.2747	0.885	0.846	12
499	525	499_S	525_S	0.2736	0.882	0.843	26
727	731	727_E	731_L	0.2735	0.881	0.842	4
544	571	544_K	571_M	0.2729	0.879	0.84	27
777	780	777_N	780_S	0.2727	0.879	0.84	3
698	719	698_K	719_D	0.272	0.876	0.838	21
336	339	336_A	339_I	0.2717	0.876	0.838	3
317	329	317_G	329_A	0.2715	0.875	0.837	12
600	624	600_S	624_L	0.2714	0.875	0.837	24
801	805	801_Y	805_P	0.2714	0.874	0.836	4
136	139	136_S	139_Y	0.2712	0.874	0.836	3
570	573	570_N	573_K	0.2712	0.874	0.836	3
270	273	270_M	273_R	0.2712	0.874	0.836	3
218	230	218_A	230_F	0.2709	0.873	0.835	12
366	487	366_R	487_E	0.2707	0.872	0.834	121
452	456	452_A	456_L	0.27	0.87	0.832	4
503	507	503_Y	507_L	0.2697	0.869	0.831	4
748	752	748_F	752_V	0.2695	0.869	0.831	4
437	441	437_I	441_N	0.2692	0.868	0.83	4
186	190	186_S	190_E	0.2692	0.867	0.829	4
730	734	730_A	734_S	0.2687	0.866	0.828	4
347	370	347_L	370_S	0.2685	0.865	0.827	23
755	760	755_I	760_P	0.2679	0.863	0.825	5
569	611	569_A	611_N	0.2671	0.861	0.823	42
332	336	332_A	336_A	0.2664	0.859	0.821	4
487	491	487_E	491_L	0.266	0.857	0.819	4
619	622	619_V	622_A	0.2659	0.857	0.819	3
489	517	489_Q	517_L	0.2657	0.856	0.818	28
231	261	231_R	261_K	0.2657	0.856	0.818	30
463	466	463_S	466_N	0.2653	0.855	0.817	3
292	297	292_A	297_D	0.2652	0.855	0.817	5
318	349	318_L	349_A	0.2647	0.853	0.815	31
180	202	180_N	202_K	0.2634	0.849	0.811	22
570	574	570_N	574_S	0.2632	0.848	0.81	4
267	271	267_A	271_L	0.2631	0.848	0.81	4
353	357	353_V	357_T	0.2629	0.847	0.809	4
735	739	735_L	739_Y	0.2628	0.847	0.809	4
766	769	766_L	769_L	0.2628	0.847	0.809	3
487	490	487_E	490_K	0.2624	0.846	0.808	3
300	304	300_A	304_L	0.2622	0.845	0.807	4
362	366	362_D	366_R	0.2622	0.845	0.807	4
729	759	729_Y	759_N	0.2622	0.845	0.807	30
199	203	199_S	203_A	0.2613	0.842	0.803	4
176	179	176_E	179_S	0.2611	0.842	0.803	3
347	373	347_L	373_N	0.261	0.841	0.802	26
180	206	180_N	206_N	0.2604	0.839	0.8	26
204	213	204_I	213_A	0.2597	0.837	0.798	9
252	283	252_Y	283_A	0.2589	0.834	0.795	31
799	803	799_S	803_T	0.2587	0.834	0.795	4
449	474	449_S	474_N	0.2586	0.833	0.793	25
366	521	366_R	521_H	0.2586	0.833	0.793	155
333	350	333_L	350_L	0.2582	0.832	0.792	17
331	335	331_V	335_T	0.2581	0.832	0.792	4
714	717	714_T	717_Y	0.2572	0.829	0.789	3
314	346	314_L	346_S	0.2571	0.828	0.788	32
198	202	198_E	202_K	0.2562	0.826	0.785	4
281	307	281_D	307_Q	0.2562	0.826	0.785	26
366	369	366_R	369_N	0.2558	0.824	0.783	3
301	320	301_I	320_Y	0.2555	0.823	0.782	19
141	144	141_D	144_R	0.2553	0.823	0.782	3
247	250	247_S	250_Y	0.2552	0.823	0.782	3
573	616	573_K	616_Q	0.2546	0.821	0.78	43
259	290	259_Y	290_I	0.2545	0.82	0.778	31
733	754	733_N	754_A	0.2545	0.82	0.778	21
251	276	251_D	276_M	0.2545	0.82	0.778	25
351	366	351_T	366_R	0.2541	0.819	0.777	15
370	373	370_S	373_N	0.2536	0.817	0.775	3
476	508	476_A	508_T	0.2534	0.817	0.775	32
596	599	596_D	599_L	0.2534	0.817	0.775	3
600	623	600_S	623_K	0.2533	0.816	0.774	23
180	203	180_N	203_A	0.2528	0.815	0.772	23
526	535	526_Y	535_A	0.2527	0.814	0.771	9
285	289	285_Y	289_K	0.2523	0.813	0.77	4
138	147	138_K	147_G	0.2523	0.813	0.77	9
152	167	152_A	167_V	0.2522	0.813	0.77	15
137	147	137_Y	147_G	0.2507	0.808	0.764	10
541	568	541_F	568_K	0.2506	0.808	0.764	27
366	370	366_R	370_S	0.2503	0.807	0.763	4
285	315	285_Y	315_S	0.2502	0.806	0.761	30
525	528	525_S	528_L	0.25	0.806	0.761	3
169	173	169_E	173_V	0.2497	0.805	0.76	4
763	767	763_A	767_L	0.2495	0.804	0.759	4
313	336	313_S	336_A	0.2494	0.804	0.759	23
728	753	728_A	753_A	0.2494	0.804	0.759	25
441	470	441_N	470_A	0.2493	0.803	0.758	29
693	697	693_E	697_I	0.2489	0.802	0.756	4
507	522	507_L	522_F	0.2487	0.802	0.756	15
321	326	321_A	326_Y	0.2484	0.801	0.755	5
469	473	469_I	473_I	0.2481	0.799	0.752	4
172	180	172_A	180_N	0.2477	0.798	0.751	8
252	256	252_Y	256_L	0.2477	0.798	0.751	4
541	571	541_F	571_M	0.2477	0.798	0.751	30
259	286	259_Y	286_L	0.2475	0.798	0.751	27
256	286	256_L	286_L	0.2469	0.796	0.749	30
272	275	272_Q	275_D	0.2467	0.795	0.747	3
681	697	681_V	697_I	0.2466	0.795	0.747	16
292	319	292_A	319_L	0.2465	0.795	0.747	27
188	193	188_M	193_F	0.246	0.793	0.745	5
778	804	778_K	804_L	0.2458	0.792	0.743	26
271	290	271_L	290_I	0.2457	0.792	0.743	19
481	508	481_L	508_T	0.2457	0.792	0.743	27
543	547	543_A	547_D	0.2455	0.791	0.742	4
198	201	198_E	201_K	0.245	0.79	0.741	3
457	475	457_N	475_Y	0.2445	0.788	0.738	18
231	258	231_R	258_N	0.2442	0.787	0.737	27
732	753	732_Y	753_A	0.244	0.786	0.735	21
620	624	620_K	624_L	0.2435	0.785	0.734	4
374	379	374_D	379_K	0.2435	0.785	0.734	5
760	787	760_P	787_L	0.243	0.783	0.731	27
144	147	144_R	147_G	0.2422	0.78	0.727	3
318	333	318_L	333_L	0.2418	0.779	0.726	15
329	333	329_A	333_L	0.2418	0.779	0.726	4
161	186	161_V	186_S	0.2416	0.779	0.726	25
204	217	204_I	217_A	0.2411	0.777	0.723	13
461	493	461_A	493_K	0.241	0.777	0.723	32
292	355	292_A	355_I	0.2409	0.776	0.722	63
444	474	444_D	474_N	0.2406	0.775	0.721	30
490	494	490_K	494_D	0.2404	0.775	0.721	4
568	572	568_K	572_Q	0.2404	0.775	0.721	4
441	456	441_N	456_L	0.2399	0.773	0.718	15
601	605	601_L	605_A	0.2399	0.773	0.718	4
525	535	525_S	535_A	0.2397	0.772	0.716	10
348	352	348_A	352_L	0.2393	0.771	0.715	4
542	572	542_C	572_Q	0.2393	0.771	0.715	30
436	462	436_Y	462_L	0.2389	0.77	0.714	26
214	237	214_A	237_A	0.2387	0.769	0.712	23
767	771	767_L	771_K	0.2387	0.769	0.712	4
272	299	272_Q	299_K	0.2385	0.769	0.712	27
714	749	714_T	749_L	0.2385	0.769	0.712	35
730	733	730_A	733_N	0.2383	0.768	0.711	3
459	462	459_S	462_L	0.2383	0.768	0.711	3
502	525	502_H	525_S	0.2381	0.767	0.709	23
604	620	604_E	620_K	0.2381	0.767	0.709	16
236	240	236_L	240_Y	0.238	0.767	0.709	4
222	227	222_L	227_K	0.2379	0.767	0.709	5
694	722	694_R	722_A	0.2374	0.765	0.706	28
365	454	365_A	454_V	0.2372	0.764	0.705	89
542	545	542_C	545_L	0.2371	0.764	0.705	3
782	785	782_A	785_G	0.2369	0.764	0.705	3
148	170	148_M	170_Q	0.2368	0.763	0.704	22
193	220	193_F	220_C	0.2365	0.762	0.702	27
760	791	760_P	791_V	0.2356	0.759	0.698	31
327	330	327_A	330_K	0.2356	0.759	0.698	3
303	307	303_Q	307_Q	0.2349	0.757	0.695	4
582	596	582_N	596_D	0.2349	0.757	0.695	14
752	783	752_V	783_A	0.2343	0.755	0.692	31
264	290	264_Y	290_I	0.2342	0.755	0.692	26
188	216	188_M	216_N	0.2338	0.753	0.689	28
265	269	265_P	269_Q	0.2338	0.753	0.689	4
218	237	218_A	237_A	0.2336	0.753	0.689	19
231	257	231_R	257_I	0.2335	0.753	0.689	26
473	488	473_I	488_F	0.2335	0.752	0.688	15
469	491	469_I	491_L	0.2334	0.752	0.688	22
315	318	315_S	318_L	0.2334	0.752	0.688	3
305	328	305_N	328_K	0.2333	0.752	0.688	23
786	790	786_M	790_E	0.2332	0.751	0.686	4
768	788	768_Q	788_Y	0.233	0.751	0.686	20
447	513	447_D	513_Q	0.2323	0.749	0.683	66
457	483	457_N	483_L	0.2321	0.748	0.682	26
303	306	303_Q	306_S	0.232	0.748	0.682	3
211	237	211_S	237_A	0.2319	0.747	0.68	26
214	236	214_A	236_L	0.2315	0.746	0.679	22
236	239	236_L	239_V	0.2314	0.746	0.679	3
762	766	762_S	766_L	0.2314	0.746	0.679	4
690	718	690_L	718_L	0.2307	0.743	0.674	28
696	700	696_K	700_L	0.2306	0.743	0.674	4
569	607	569_A	607_V	0.2304	0.743	0.674	38
335	339	335_T	339_I	0.2301	0.741	0.671	4
147	150	147_G	150_Q	0.2299	0.741	0.671	3
308	313	308_G	313_S	0.2298	0.741	0.671	5
474	478	474_N	478_N	0.2291	0.738	0.667	4
711	714	711_I	714_T	0.2283	0.736	0.664	3
326	356	326_Y	356_K	0.2279	0.735	0.662	30
749	752	749_L	752_V	0.2278	0.734	0.66	3
716	753	716_A	753_A	0.2277	0.734	0.66	37
167	170	167_V	170_Q	0.2276	0.734	0.66	3
149	153	149_I	153_N	0.2272	0.732	0.657	4
326	357	326_Y	357_T	0.2269	0.731	0.656	31
720	732	720_I	732_Y	0.2264	0.729	0.653	12
708	711	708_D	711_I	0.2261	0.729	0.653	3
755	763	755_I	763_A	0.2261	0.729	0.653	8
481	511	481_L	511_Q	0.226	0.728	0.651	30
508	512	508_T	512_M	0.2259	0.728	0.651	4
783	786	783_A	786_M	0.2252	0.726	0.648	3
709	740	709_E	740_G	0.2251	0.726	0.648	31
542	602	542_C	602_I	0.225	0.725	0.647	60
164	186	164_A	186_S	0.2246	0.724	0.645	22
725	756	725_Y	756_G	0.2243	0.723	0.643	31
725	757	725_Y	757_A	0.2241	0.722	0.642	32
314	318	314_L	318_L	0.2235	0.72	0.639	4
137	140	137_Y	140_N	0.2233	0.72	0.639	3
152	164	152_A	164_A	0.2231	0.719	0.637	12
332	335	332_A	335_T	0.2227	0.718	0.635	3
479	513	479_Q	513_Q	0.2225	0.717	0.634	34
292	304	292_A	304_L	0.222	0.715	0.631	12
368	386	368_Q	386_I	0.222	0.715	0.631	18
468	491	468_K	491_L	0.222	0.715	0.631	23
199	202	199_S	202_K	0.2216	0.714	0.629	3
268	296	268_L	296_F	0.2213	0.713	0.627	28
482	485	482_R	485_N	0.2211	0.713	0.627	3
653	656	653_Q	656_Q	0.221	0.712	0.626	3
751	787	751_A	787_L	0.2209	0.712	0.626	36
332	455	332_A	455_Y	0.2208	0.711	0.624	123
450	482	450_A	482_R	0.2207	0.711	0.624	32
148	171	148_M	171_V	0.2207	0.711	0.624	23
288	303	288_A	303_Q	0.2203	0.71	0.623	15
571	575	571_M	575_M	0.2198	0.709	0.621	4
720	725	720_I	725_Y	0.2194	0.707	0.618	5
527	577	527_H	577_F	0.2189	0.705	0.615	50
605	637	605_A	637_L	0.2189	0.705	0.615	32
690	694	690_L	694_R	0.2186	0.704	0.613	4
172	179	172_A	179_S	0.2185	0.704	0.613	7
483	487	483_L	487_E	0.2183	0.704	0.613	4
156	161	156_Y	161_V	0.2183	0.703	0.611	5
310	343	310_F	343_F	0.2181	0.703	0.611	33
636	639	636_I	639_F	0.2176	0.701	0.608	3
177	180	177_S	180_N	0.2175	0.701	0.608	3
148	174	148_M	174_Y	0.2174	0.701	0.608	26
523	544	523_S	544_K	0.217	0.699	0.605	21
499	529	499_S	529_N	0.2164	0.697	0.601	30
495	501	495_Y	501_L	0.2161	0.696	0.6	6
747	770	747_L	770_S	0.2159	0.696	0.6	23
454	458	454_V	458_T	0.2158	0.695	0.598	4
289	304	289_K	304_L	0.2158	0.695	0.598	15
338	372	338_K	372_D	0.2158	0.695	0.598	34
476	481	476_A	481_L	0.2157	0.695	0.598	5
537	575	537_A	575_M	0.2155	0.694	0.596	38
284	307	284_K	307_Q	0.2153	0.694	0.596	23
615	618	615_N	618_D	0.2152	0.694	0.596	3
210	213	210_Q	213_A	0.2152	0.693	0.595	3
326	360	326_Y	360_Y	0.215	0.693	0.595	34
230	234	230_F	234_I	0.215	0.693	0.595	4
215	219	215_I	219_V	0.2147	0.692	0.593	4
172	183	172_A	183_L	0.2145	0.691	0.592	11
266	270	266_E	270_M	0.2135	0.688	0.587	4
486	520	486_Q	520_K	0.2133	0.687	0.585	34
796	800	796_A	800_Q	0.2132	0.687	0.585	4
523	552	523_S	552_K	0.2128	0.686	0.583	29
606	611	606_I	611_N	0.2127	0.685	0.582	5
233	236	233_Y	236_L	0.2125	0.685	0.582	3
349	352	349_A	352_L	0.2124	0.684	0.58	3
470	473	470_A	473_I	0.2121	0.684	0.58	3
766	770	766_L	770_S	0.2115	0.682	0.576	4
321	349	321_A	349_A	0.2113	0.681	0.575	28
713	746	713_Q	746_T	0.2113	0.681	0.575	33
582	595	582_N	595_K	0.2112	0.681	0.575	13
469	501	469_I	501_L	0.2112	0.681	0.575	32
288	319	288_A	319_L	0.2111	0.68	0.573	31
684	696	684_M	696_K	0.2109	0.68	0.573	12
370	382	370_S	382_D	0.2109	0.68	0.573	12
271	287	271_L	287_S	0.2108	0.679	0.571	16
330	359	330_K	359_N	0.2106	0.679	0.571	29
538	542	538_F	542_C	0.2104	0.678	0.57	4
577	626	577_F	626_S	0.2093	0.675	0.565	49
455	459	455_Y	459_S	0.2091	0.674	0.563	4
800	803	800_Q	803_T	0.2091	0.674	0.563	3
219	234	219_V	234_I	0.2089	0.673	0.561	15
527	626	527_H	626_S	0.2087	0.673	0.561	99
601	637	601_L	637_L	0.2083	0.671	0.558	36
365	486	365_A	486_Q	0.2083	0.671	0.558	121
694	719	694_R	719_D	0.2082	0.671	0.558	25
732	736	732_Y	736_I	0.2082	0.671	0.558	4
716	749	716_A	749_L	0.2081	0.671	0.558	33
717	752	717_Y	752_V	0.2081	0.67	0.556	35
619	623	619_V	623_K	0.2078	0.67	0.556	4
639	697	639_F	697_I	0.2073	0.668	0.553	58
620	623	620_K	623_K	0.2072	0.668	0.553	3
515	543	515_Y	543_A	0.2072	0.668	0.553	28
755	787	755_I	787_L	0.207	0.667	0.551	32
455	521	455_Y	521_H	0.2069	0.667	0.551	66
136	140	136_S	140_N	0.2068	0.666	0.549	4
683	687	683_L	687_A	0.2068	0.666	0.549	4
303	332	303_Q	332_A	0.2067	0.666	0.549	29
436	459	436_Y	459_S	0.2066	0.666	0.549	23
455	487	455_Y	487_E	0.2064	0.665	0.548	32
194	198	194_Q	198_E	0.2063	0.665	0.548	4
361	365	361_Q	365_A	0.2061	0.664	0.546	4
334	489	334_S	489_Q	0.206	0.664	0.546	155
238	241	238_Q	241_L	0.2059	0.664	0.546	3
596	600	596_D	600_S	0.2055	0.662	0.543	4
216	219	216_N	219_V	0.2052	0.661	0.541	3
476	504	476_A	504_N	0.205	0.661	0.541	28
301	364	301_I	364_L	0.2049	0.66	0.539	63
229	233	229_K	233_Y	0.2049	0.66	0.539	4
488	508	488_F	508_T	0.2045	0.659	0.538	20
717	720	717_Y	720_I	0.2042	0.658	0.536	3
163	167	163_Q	167_V	0.2041	0.658	0.536	4
504	507	504_N	507_L	0.2037	0.657	0.534	3
481	512	481_L	512_M	0.2036	0.656	0.532	31
596	708	596_D	708_D	0.2035	0.656	0.532	112
487	620	487_E	620_K	0.2034	0.656	0.532	133
235	266	235_D	266_E	0.2034	0.655	0.531	31
489	521	489_Q	521_H	0.2032	0.655	0.531	32
188	220	188_M	220_C	0.2032	0.655	0.531	32
486	489	486_Q	489_Q	0.2031	0.655	0.531	3
484	508	484_A	508_T	0.2031	0.654	0.529	24
490	524	490_K	524_S	0.2027	0.653	0.527	34
201	229	201_K	229_K	0.2027	0.653	0.527	28
285	312	285_Y	312_S	0.2026	0.653	0.527	27
331	486	331_V	486_Q	0.2025	0.653	0.527	155
797	801	797_A	801_Y	0.2023	0.652	0.526	4
338	626	338_K	626_S	0.2021	0.651	0.524	288
348	370	348_A	370_S	0.2021	0.651	0.524	22
252	280	252_Y	280_S	0.2017	0.65	0.522	28
355	476	355_I	476_A	0.2015	0.649	0.52	121
256	260	256_L	260_Y	0.2013	0.649	0.52	4
211	214	211_S	214_A	0.2012	0.648	0.519	3
765	768	765_A	768_Q	0.2012	0.648	0.519	3
636	640	636_I	640_N	0.201	0.648	0.519	4
493	527	493_K	527_H	0.201	0.648	0.519	34
269	365	269_Q	365_A	0.2008	0.647	0.517	96
618	641	618_D	641_S	0.2007	0.647	0.517	23
215	253	215_I	253_Y	0.2007	0.647	0.517	38
181	216	181_Y	216_N	0.2006	0.646	0.515	35
272	291	272_Q	291_Y	0.2001	0.645	0.514	19
521	525	521_H	525_S	0.1996	0.643	0.51	4
800	804	800_Q	804_L	0.1994	0.643	0.51	4
222	253	222_L	253_Y	0.1993	0.642	0.508	31
225	260	225_N	260_Y	0.1992	0.642	0.508	35
695	698	695_Q	698_K	0.1991	0.642	0.508	3
313	339	313_S	339_I	0.1991	0.642	0.508	26
713	748	713_Q	748_F	0.1991	0.642	0.508	35
205	239	205_A	239_V	0.1986	0.64	0.505	34
692	696	692_L	696_K	0.1984	0.64	0.505	4
604	617	604_E	617_V	0.1984	0.639	0.503	13
523	622	523_S	622_A	0.1982	0.639	0.503	99
150	153	150_Q	153_N	0.198	0.638	0.502	3
347	600	347_L	600_S	0.1979	0.638	0.502	253
237	240	237_A	240_Y	0.1979	0.638	0.502	3
334	337	334_S	337_M	0.1978	0.637	0.5	3
264	294	264_Y	294_M	0.1976	0.637	0.5	30
778	785	778_K	785_G	0.1974	0.636	0.498	7
321	356	321_A	356_K	0.1971	0.635	0.496	35
691	695	691_N	695_Q	0.1971	0.635	0.496	4
746	749	746_T	749_L	0.1969	0.635	0.496	3
162	166	162_E	166_K	0.1969	0.634	0.495	4
752	756	752_V	756_G	0.1968	0.634	0.495	4
368	489	368_Q	489_Q	0.1968	0.634	0.495	121
545	550	545_L	550_T	0.1967	0.634	0.495	5
681	693	681_V	693_E	0.1966	0.634	0.495	12
340	346	340_E	346_S	0.1966	0.633	0.493	6
460	471	460_K	471_N	0.1963	0.633	0.493	11
333	488	333_L	488_F	0.1961	0.632	0.491	155
289	318	289_K	318_L	0.1958	0.631	0.49	29
324	358	324_G	358_G	0.1956	0.63	0.488	34
241	247	241_L	247_S	0.1956	0.63	0.488	6
469	498	469_I	498_H	0.1952	0.629	0.486	29
322	445	322_R	445_F	0.1952	0.629	0.486	123
725	729	725_Y	729_Y	0.1951	0.629	0.486	4
196	220	196_A	220_C	0.1951	0.629	0.486	24
222	234	222_L	234_I	0.1951	0.629	0.486	12
789	794	789_Q	794_Y	0.195	0.628	0.484	5
328	332	328_K	332_A	0.1949	0.628	0.484	4
516	520	516_E	520_K	0.1949	0.628	0.484	4
524	623	524_S	623_K	0.1947	0.628	0.484	99
506	543	506_A	543_A	0.1947	0.627	0.483	37
362	451	362_D	451_D	0.1947	0.627	0.483	89
752	755	752_V	755_I	0.1946	0.627	0.483	3
510	515	510_A	515_Y	0.1945	0.627	0.483	5
293	356	293_K	356_K	0.1944	0.626	0.481	63
510	518	510_A	518_A	0.1942	0.626	0.481	8
149	171	149_I	171_V	0.1938	0.625	0.479	22
440	455	440_A	455_Y	0.1936	0.624	0.478	15
371	382	371_Y	382_D	0.1935	0.624	0.478	11
597	600	597_T	600_S	0.1933	0.623	0.476	3
244	247	244_E	247_S	0.1932	0.623	0.476	3
720	749	720_I	749_L	0.1929	0.622	0.474	29
361	450	361_Q	450_A	0.1928	0.621	0.472	89
455	458	455_Y	458_T	0.1928	0.621	0.472	3
764	793	764_I	793_N	0.1927	0.621	0.472	29
181	203	181_Y	203_A	0.1927	0.621	0.472	22
384	388	384_Y	388_V	0.1926	0.621	0.472	4
600	627	600_S	627_E	0.1925	0.62	0.471	27
740	746	740_G	746_T	0.1924	0.62	0.471	6
281	284	281_D	284_K	0.1923	0.62	0.471	3
571	574	571_M	574_S	0.1923	0.62	0.471	3
650	653	650_E	653_Q	0.1922	0.619	0.469	3
786	789	786_M	789_Q	0.1921	0.619	0.469	3
454	619	454_V	619_V	0.192	0.619	0.469	165
407	412	407_D	412_Q	0.192	0.619	0.469	5
476	545	476_A	545_L	0.192	0.619	0.469	69
303	366	303_Q	366_R	0.1916	0.618	0.467	63
275	338	275_D	338_K	0.1916	0.618	0.467	63
781	804	781_K	804_L	0.1916	0.617	0.466	23
365	368	365_A	368_Q	0.1913	0.616	0.464	3
461	527	461_A	527_H	0.1908	0.615	0.462	66
696	699	696_K	699_E	0.1907	0.615	0.462	3
597	628	597_T	628_L	0.1905	0.614	0.46	31
468	494	468_K	494_D	0.1905	0.614	0.46	26
267	290	267_A	290_I	0.1902	0.613	0.459	23
442	446	442_V	446_V	0.1902	0.613	0.459	4
292	321	292_A	321_A	0.1901	0.613	0.459	29
542	546	542_C	546_I	0.1901	0.613	0.459	4
154	158	154_A	158_K	0.19	0.612	0.457	4
516	551	516_E	551_T	0.19	0.612	0.457	35
233	237	233_Y	237_A	0.1898	0.612	0.457	4
367	488	367_L	488_F	0.1897	0.611	0.455	121
433	459	433_A	459_S	0.1893	0.61	0.454	26
502	528	502_H	528_L	0.1892	0.61	0.454	26
780	783	780_S	783_A	0.1892	0.61	0.454	3
368	457	368_Q	457_N	0.1889	0.609	0.452	89
451	483	451_D	483_L	0.1887	0.608	0.45	32
166	169	166_K	169_E	0.1882	0.607	0.449	3
368	439	368_Q	439_K	0.1882	0.607	0.449	71
794	798	794_Y	798_I	0.1881	0.606	0.447	4
264	268	264_Y	268_L	0.188	0.606	0.447	4
333	353	333_L	353_V	0.188	0.606	0.447	20
736	750	736_I	750_A	0.1878	0.605	0.445	14
761	764	761_N	764_I	0.1878	0.605	0.445	3
456	471	456_L	471_N	0.1876	0.605	0.445	15
227	257	227_K	257_I	0.1875	0.604	0.443	30
749	783	749_L	783_A	0.1873	0.604	0.443	34
601	624	601_L	624_L	0.187	0.603	0.442	23
763	787	763_A	787_L	0.187	0.603	0.442	24
149	182	149_I	182_N	0.187	0.603	0.442	33
368	622	368_Q	622_A	0.187	0.602	0.44	254
298	327	298_S	327_A	0.1867	0.602	0.44	29
697	701	697_I	701_I	0.1865	0.601	0.438	4
681	684	681_V	684_M	0.1862	0.6	0.437	3
185	189	185_V	189_N	0.1861	0.6	0.437	4
503	525	503_Y	525_S	0.1861	0.6	0.437	22
489	509	489_Q	509_Y	0.186	0.6	0.437	20
148	152	148_M	152_A	0.1859	0.599	0.435	4
374	463	374_D	463_S	0.1858	0.599	0.435	89
457	523	457_N	523_S	0.1857	0.598	0.433	66
401	405	401_Q	405_S	0.1856	0.598	0.433	4
488	505	488_F	505_L	0.1855	0.598	0.433	17
605	610	605_A	610_N	0.1855	0.598	0.433	5
250	254	250_Y	254_L	0.1855	0.598	0.433	4
429	432	429_D	432_Q	0.1853	0.597	0.432	3
365	520	365_A	520_K	0.1848	0.596	0.43	155
507	539	507_L	539_A	0.1847	0.595	0.428	32
331	365	331_V	365_A	0.1846	0.595	0.428	34
693	700	693_E	700_L	0.1842	0.594	0.427	7
516	519	516_E	519_Y	0.1842	0.594	0.427	3
355	360	355_I	360_Y	0.184	0.593	0.425	5
379	382	379_K	382_D	0.1839	0.593	0.425	3
262	293	262_G	293_K	0.1838	0.592	0.423	31
352	355	352_L	355_I	0.1838	0.592	0.423	3
521	620	521_H	620_K	0.1837	0.592	0.423	99
387	390	387_Q	390_L	0.1835	0.591	0.422	3
368	523	368_Q	523_S	0.1834	0.591	0.422	155
454	486	454_V	486_Q	0.1834	0.591	0.422	32
321	329	321_A	329_A	0.1834	0.591	0.422	8
761	765	761_N	765_A	0.1832	0.59	0.42	4
717	721	717_Y	721_F	0.1832	0.59	0.42	4
470	504	470_A	504_N	0.1831	0.59	0.42	34
701	705	701_I	705_G	0.1831	0.59	0.42	4
259	267	259_Y	267_A	0.1828	0.589	0.418	8
408	411	408_L	411_K	0.1828	0.589	0.418	3
358	612	358_G	612_N	0.1828	0.589	0.418	254
635	696	635_N	696_K	0.1825	0.588	0.417	61
520	523	520_K	523_S	0.1825	0.588	0.417	3
181	213	181_Y	213_A	0.1824	0.588	0.417	32
701	715	701_I	715_L	0.182	0.586	0.413	14
148	151	148_M	151_K	0.1819	0.586	0.413	3
338	493	338_K	493_K	0.1818	0.586	0.413	155
376	630	376_D	630_E	0.1818	0.586	0.413	254
457	733	457_N	733_N	0.1818	0.586	0.413	276
238	254	238_Q	254_L	0.1817	0.586	0.413	16
248	251	248_K	251_D	0.1814	0.585	0.412	3
443	509	443_T	509_Y	0.1813	0.584	0.41	66
702	737	702_N	737_D	0.1812	0.584	0.41	35
770	773	770_S	773_T	0.181	0.583	0.408	3
327	450	327_A	450_A	0.181	0.583	0.408	123
785	789	785_G	789_Q	0.181	0.583	0.408	4
517	521	517_L	521_H	0.1809	0.583	0.408	4
177	207	177_S	207_G	0.1809	0.583	0.408	30
286	289	286_L	289_K	0.1807	0.582	0.407	3
677	681	677_R	681_V	0.1806	0.582	0.407	4
320	323	320_Y	323_I	0.1805	0.582	0.407	3
720	756	720_I	756_G	0.1805	0.582	0.407	36
731	766	731_L	766_L	0.1805	0.582	0.407	35
203	206	203_A	206_N	0.1802	0.581	0.405	3
345	500	345_Q	500_I	0.1801	0.581	0.405	155
449	477	449_S	477_L	0.1801	0.581	0.405	28
199	270	199_S	270_M	0.18	0.58	0.403	71
515	614	515_Y	614_N	0.1799	0.58	0.403	99
318	352	318_L	352_L	0.1797	0.579	0.402	34
408	412	408_L	412_Q	0.1796	0.579	0.402	4
259	293	259_Y	293_K	0.1795	0.579	0.402	34
449	453	449_S	453_G	0.1795	0.578	0.4	4
271	333	271_L	333_L	0.1794	0.578	0.4	62
322	477	322_R	477_L	0.1794	0.578	0.4	155
755	790	755_I	790_E	0.1794	0.578	0.4	35
215	250	215_I	250_Y	0.1793	0.578	0.4	35
355	444	355_I	444_D	0.1793	0.578	0.4	89
731	734	731_L	734_S	0.1793	0.578	0.4	3
479	548	479_Q	548_I	0.1793	0.578	0.4	69
578	582	578_L	582_N	0.1792	0.578	0.4	4
238	250	238_Q	250_Y	0.179	0.577	0.398	12
462	627	462_L	627_E	0.1789	0.577	0.398	165
269	272	269_Q	272_Q	0.1789	0.576	0.397	3
520	570	520_K	570_N	0.1788	0.576	0.397	50
331	454	331_V	454_V	0.1788	0.576	0.397	123
193	223	193_F	223_K	0.1787	0.576	0.397	30
450	454	450_A	454_V	0.1787	0.576	0.397	4
150	154	150_Q	154_A	0.1787	0.576	0.397	4
358	479	358_G	479_Q	0.1787	0.576	0.397	121
309	343	309_N	343_F	0.1785	0.575	0.395	34
713	735	713_Q	735_L	0.1784	0.575	0.395	22
478	722	478_N	722_A	0.1784	0.575	0.395	244
264	326	264_Y	326_Y	0.1784	0.575	0.395	62
371	383	371_Y	383_A	0.1782	0.574	0.393	12
521	571	521_H	571_M	0.1779	0.573	0.392	50
297	319	297_D	319_L	0.1779	0.573	0.392	22
327	331	327_A	331_V	0.1779	0.573	0.392	4
798	801	798_I	801_Y	0.1778	0.573	0.392	3
643	647	643_N	647_N	0.1776	0.572	0.39	4
507	511	507_L	511_Q	0.1774	0.572	0.39	4
319	508	319_L	508_T	0.1774	0.572	0.39	189
457	489	457_N	489_Q	0.1772	0.571	0.388	32
305	368	305_N	368_Q	0.1771	0.571	0.388	63
507	510	507_L	510_A	0.1769	0.57	0.387	3
573	607	573_K	607_V	0.1769	0.57	0.387	34
712	735	712_L	735_L	0.1769	0.57	0.387	23
182	185	182_N	185_V	0.1768	0.57	0.387	3
510	543	510_A	543_A	0.1767	0.569	0.385	33
331	520	331_V	520_K	0.1767	0.569	0.385	189
369	524	369_N	524_S	0.1767	0.569	0.385	155
522	526	522_F	526_Y	0.1766	0.569	0.385	4
323	478	323_I	478_N	0.1765	0.569	0.385	155
286	315	286_L	315_S	0.1765	0.569	0.385	29
652	656	652_A	656_Q	0.1764	0.568	0.384	4
476	511	476_A	511_Q	0.1762	0.568	0.384	35
704	711	704_S	711_I	0.1761	0.567	0.382	7
487	571	487_E	571_M	0.176	0.567	0.382	84
201	272	201_K	272_Q	0.1759	0.567	0.382	71
626	737	626_S	737_D	0.1759	0.567	0.382	111
695	699	695_Q	699_E	0.1758	0.566	0.38	4
298	450	298_S	450_A	0.1757	0.566	0.38	152
513	612	513_Q	612_N	0.1756	0.566	0.38	99
156	186	156_Y	186_S	0.1756	0.566	0.38	30
256	259	256_L	259_Y	0.1756	0.566	0.38	3
463	529	463_S	529_N	0.1754	0.565	0.379	66
799	802	799_S	802_K	0.1754	0.565	0.379	3
522	543	522_F	543_A	0.1753	0.565	0.379	21
526	530	526_Y	530_P	0.1752	0.565	0.379	4
523	573	523_S	573_K	0.1752	0.565	0.379	50
647	651	647_N	651_Y	0.1751	0.564	0.377	4
451	455	451_D	455_Y	0.175	0.564	0.377	4
348	437	348_A	437_I	0.1749	0.564	0.377	89
694	724	694_R	724_Q	0.1747	0.563	0.375	30
706	734	706_A	734_S	0.1747	0.563	0.375	28
340	495	340_E	495_Y	0.1747	0.563	0.375	155
477	511	477_L	511_Q	0.1746	0.563	0.375	34