i	j	i_id	j_id	r_sco	s_sco	prob	distance
349	352	349_E	352_Q	2.4705	4.018	1	3
383	386	383_N	386_L	2.4418	3.971	1	3
494	497	494_N	497_N	2.4156	3.929	1	3
460	463	460_K	463_E	2.3877	3.883	1	3
85	88	85_E	88_Q	2.384	3.877	1	3
145	148	145_N	148_L	2.3717	3.857	1	3
246	249	246_D	249_M	2.3681	3.851	1	3
417	420	417_E	420_T	2.3594	3.837	1	3
280	283	280_K	283_E	2.2871	3.72	1	3
315	318	315_K	318_H	2.2835	3.714	1	3
52	55	52_Q	55_R	2.1371	3.476	1	3
18	21	18_Q	21_S	1.6906	2.749	1	3
529	532	529_D	532_A	1.6823	2.736	1	3
482	501	482_Y	501_Y	1.4507	2.359	1	19
109	112	109_K	112_S	1.4447	2.35	1	3
448	467	448_L	467_Y	1.2972	2.11	1	19
133	152	133_C	152_S	1.2967	2.109	1	19
465	469	465_L	469_R	1.2796	2.081	1	4
452	468	452_G	468_H	1.2628	2.054	1	16
375	391	375_G	391_F	1.2516	2.035	1	16
405	424	405_M	424_W	1.247	2.028	1	19
341	357	341_G	357_Y	1.2407	2.018	1	16
150	154	150_T	154_K	1.2298	2	1	4
137	153	137_G	153_Y	1.2267	1.995	1	16
409	425	409_G	425_F	1.2167	1.979	1	16
451	467	451_L	467_Y	1.2068	1.963	1	16
251	255	251_Y	255_S	1.2043	1.959	1	4
486	502	486_G	502_F	1.1978	1.948	1	16
306	323	306_G	323_L	1.1886	1.933	1	17
354	358	354_M	358_F	1.1444	1.861	1	4
324	340	324_S	340_Y	1.1416	1.857	1	16
136	152	136_R	152_S	1.1269	1.833	1	16
374	390	374_I	390_F	1.1173	1.817	1	16
305	322	305_V	322_Y	1.1085	1.803	1	17
371	390	371_M	390_F	1.1017	1.792	1	19
422	426	422_E	426_L	1.0931	1.778	1	4
485	501	485_I	501_Y	1.0898	1.772	1	16
302	322	302_W	322_Y	1.0863	1.767	1	20
340	356	340_Y	356_A	1.082	1.76	1	16
408	424	408_V	424_W	1.0819	1.759	1	16
499	503	499_V	503_H	1.0715	1.743	0.999	4
388	392	388_E	392_S	1.0549	1.716	0.999	4
77	93	77_A	93_L	1.0383	1.689	0.999	16
320	324	320_R	324_S	1.0367	1.686	0.999	4
272	288	272_I	288_S	1.0301	1.675	0.999	16
268	287	268_L	287_L	1.0265	1.669	0.999	19
392	408	392_S	408_V	1.0221	1.662	0.999	16
255	271	255_S	271_H	1.0211	1.661	0.999	16
43	47	43_L	47_L	1.0146	1.65	0.999	4
238	254	238_A	254_T	1.0128	1.647	0.999	16
337	356	337_W	356_A	1.0114	1.645	0.999	19
303	336	303_F	336_A	1.0057	1.636	0.999	33
44	60	44_A	60_L	1.0044	1.633	0.999	16
358	374	358_F	374_I	1.0038	1.633	0.999	16
136	140	136_R	140_Y	1.0029	1.631	0.999	4
374	378	374_I	378_Y	0.9992	1.625	0.999	4
90	94	90_L	94_D	0.9987	1.624	0.999	4
76	80	76_A	80_H	0.9917	1.613	0.999	4
451	455	451_L	455_C	0.9908	1.611	0.999	4
289	305	289_H	305_V	0.9826	1.598	0.999	16
344	352	344_F	352_Q	0.9796	1.593	0.999	8
318	321	318_H	321_R	0.9709	1.579	0.998	3
57	61	57_A	61_R	0.9641	1.568	0.998	4
469	485	469_R	485_I	0.9549	1.553	0.998	16
489	494	489_H	494_N	0.949	1.543	0.998	5
485	489	485_I	489_H	0.9446	1.536	0.998	4
271	275	271_H	275_L	0.9341	1.519	0.998	4
427	431	427_D	431_K	0.9337	1.519	0.998	4
140	152	140_Y	152_S	0.9331	1.518	0.998	12
237	241	237_L	241_H	0.9325	1.517	0.998	4
455	460	455_C	460_K	0.9324	1.516	0.998	5
234	253	234_V	253_L	0.9301	1.513	0.998	19
170	174	170_L	174_H	0.9297	1.512	0.998	4
271	287	271_H	287_L	0.929	1.511	0.998	16
41	72	41_Y	72_C	0.924	1.503	0.997	31
338	370	338_I	370_P	0.92	1.496	0.997	32
309	318	309_Y	318_H	0.9197	1.496	0.997	9
386	389	386_L	389_R	0.9195	1.495	0.997	3
426	451	426_L	451_L	0.9195	1.495	0.997	25
455	463	455_C	463_E	0.9119	1.483	0.997	8
312	315	312_V	315_K	0.911	1.482	0.997	3
412	417	412_A	417_E	0.9086	1.478	0.997	5
378	386	378_Y	386_L	0.9082	1.477	0.997	8
408	412	408_V	412_A	0.9082	1.477	0.997	4
179	182	179_Q	182_K	0.9071	1.475	0.997	3
88	91	88_Q	91_D	0.9067	1.475	0.997	3
372	404	372_L	404_V	0.9066	1.475	0.997	32
497	500	497_N	500_D	0.9061	1.474	0.997	3
23	27	23_L	27_D	0.9026	1.468	0.997	4
412	420	412_A	420_T	0.9012	1.466	0.997	8
73	92	73_R	92_V	0.9006	1.465	0.997	19
249	252	249_M	252_K	0.8995	1.463	0.997	3
344	356	344_F	356_A	0.8925	1.451	0.996	12
76	92	76_A	92_V	0.8892	1.446	0.996	16
140	148	140_Y	148_L	0.8889	1.446	0.996	8
378	390	378_Y	390_F	0.8865	1.442	0.996	12
235	267	235_V	267_C	0.8864	1.442	0.996	32
140	145	140_Y	145_N	0.8773	1.427	0.996	5
148	151	148_L	151_Y	0.8771	1.426	0.996	3
393	397	393_Q	397_I	0.8708	1.416	0.995	4
288	304	288_S	304_A	0.8689	1.413	0.995	16
489	497	489_H	497_N	0.8645	1.406	0.995	8
285	289	285_F	289_H	0.8637	1.405	0.995	4
40	59	40_I	59_A	0.8618	1.402	0.995	19
470	473	470_Q	473_V	0.8579	1.395	0.995	3
134	166	134_L	166_A	0.8525	1.386	0.994	32
352	355	352_Q	355_A	0.8508	1.384	0.994	3
449	484	449_N	484_A	0.8507	1.384	0.994	35
254	270	254_T	270_V	0.8489	1.381	0.994	16
463	466	463_E	466_D	0.846	1.376	0.994	3
241	249	241_H	249_M	0.843	1.371	0.994	8
275	287	275_L	287_L	0.8423	1.37	0.994	12
470	474	470_Q	474_L	0.8413	1.368	0.993	4
422	451	422_E	451_L	0.8405	1.367	0.993	29
313	316	313_G	316_N	0.8401	1.366	0.993	3
237	253	237_L	253_L	0.8378	1.363	0.993	16
340	344	340_Y	344_F	0.8373	1.362	0.993	4
305	309	305_V	309_Y	0.8362	1.36	0.993	4
309	322	309_Y	322_Y	0.8346	1.357	0.993	13
504	507	504_T	507_G	0.832	1.353	0.993	3
275	283	275_L	283_E	0.8298	1.35	0.993	8
241	253	241_H	253_L	0.8269	1.345	0.992	12
154	170	154_K	170_L	0.8261	1.343	0.992	16
61	76	61_R	76_A	0.8172	1.329	0.991	15
241	246	241_H	246_D	0.8154	1.326	0.991	5
275	280	275_L	280_K	0.8139	1.324	0.991	5
251	275	251_Y	275_L	0.8124	1.321	0.991	24
420	423	420_T	423_K	0.8085	1.315	0.991	3
323	339	323_L	339_A	0.8062	1.311	0.99	16
412	424	412_A	424_W	0.8055	1.31	0.99	12
283	286	283_E	286_Y	0.8052	1.31	0.99	3
378	383	378_Y	383_N	0.8045	1.308	0.99	5
449	481	449_N	481_T	0.8044	1.308	0.99	32
455	467	455_C	467_Y	0.8044	1.308	0.99	12
269	301	269_P	301_S	0.8033	1.306	0.99	32
391	407	391_F	407_E	0.8028	1.306	0.99	16
406	450	406_H	450_N	0.8002	1.301	0.99	44
309	315	309_Y	315_K	0.7994	1.3	0.99	6
80	88	80_H	88_Q	0.7885	1.282	0.988	8
80	92	80_H	92_V	0.7871	1.28	0.988	12
486	505	486_G	505_A	0.7838	1.275	0.988	19
153	169	153_Y	169_L	0.7782	1.266	0.987	16
372	407	372_L	407_E	0.778	1.265	0.987	35
388	408	388_E	408_V	0.7765	1.263	0.987	20
406	447	406_H	447_L	0.7751	1.261	0.986	41
425	450	425_F	450_N	0.7741	1.259	0.986	25
137	156	137_G	156_A	0.7736	1.258	0.986	19
47	55	47_L	55_R	0.7731	1.257	0.986	8
471	481	471_A	481_T	0.7714	1.255	0.986	10
394	404	394_A	404_V	0.7704	1.253	0.986	10
80	85	80_H	85_E	0.7688	1.25	0.985	5
462	492	462_A	492_M	0.7674	1.248	0.985	30
337	360	337_W	360_A	0.7673	1.248	0.985	23
452	471	452_G	471_A	0.7646	1.243	0.985	19
163	166	163_C	166_A	0.7628	1.241	0.984	3
344	349	344_F	349_E	0.7605	1.237	0.984	5
393	396	393_Q	396_S	0.7556	1.229	0.983	3
504	508	504_T	508_L	0.7552	1.228	0.983	4
427	430	427_D	430_E	0.7468	1.215	0.981	3
55	58	55_R	58_H	0.7437	1.209	0.981	3
409	428	409_G	428_A	0.7436	1.209	0.981	19
303	339	303_F	339_A	0.7408	1.205	0.98	36
78	82	78_R	82_A	0.7407	1.205	0.98	4
138	142	138_K	142_A	0.7358	1.197	0.979	4
256	260	256_V	260_K	0.7336	1.193	0.978	4
489	501	489_H	501_Y	0.7312	1.189	0.978	12
47	59	47_L	59_A	0.7307	1.188	0.978	12
468	484	468_H	484_A	0.7254	1.18	0.977	16
338	373	338_I	373_Y	0.7234	1.177	0.976	35
519	523	519_L	523_I	0.7211	1.173	0.975	4
155	158	155_E	158_K	0.7202	1.171	0.975	3
388	412	388_E	412_A	0.718	1.168	0.975	24
376	407	376_L	407_E	0.7178	1.167	0.974	31
465	488	465_L	488_I	0.7163	1.165	0.974	23
285	309	285_F	309_Y	0.7157	1.164	0.974	24
384	411	384_S	411_V	0.7151	1.163	0.974	27
465	492	465_L	492_M	0.7137	1.161	0.973	27
354	378	354_M	378_Y	0.713	1.16	0.973	24
285	312	285_F	312_V	0.7119	1.158	0.973	27
43	59	43_L	59_A	0.7088	1.153	0.972	16
465	489	465_L	489_H	0.7084	1.152	0.972	24
371	393	371_M	393_Q	0.7076	1.151	0.972	22
251	271	251_Y	271_H	0.7071	1.15	0.971	20
360	370	360_A	370_P	0.7063	1.149	0.971	10
359	363	359_T	363_L	0.7056	1.148	0.971	4
307	311	307_C	311_M	0.7048	1.146	0.971	4
388	415	388_E	415_N	0.7032	1.144	0.97	27
290	294	290_K	294_L	0.7008	1.14	0.969	4
320	340	320_R	340_Y	0.6937	1.128	0.967	20
209	213	209_L	213_N	0.6924	1.126	0.966	4
448	470	448_L	470_Q	0.6896	1.121	0.965	22
77	96	77_A	96_E	0.6848	1.114	0.964	19
47	52	47_L	52_Q	0.6839	1.112	0.963	5
466	470	466_D	470_Q	0.6838	1.112	0.963	4
239	243	239_E	243_Y	0.6836	1.112	0.963	4
290	293	290_K	293_D	0.6801	1.106	0.962	3
333	336	333_Y	336_A	0.6712	1.092	0.958	3
310	343	310_L	343_S	0.6706	1.091	0.958	33
307	339	307_C	339_A	0.6693	1.089	0.957	32
133	155	133_C	155_E	0.6692	1.088	0.957	22
21	24	21_S	24_F	0.6645	1.081	0.955	3
134	169	134_L	169_L	0.6637	1.079	0.954	35
509	512	509_R	512_D	0.6606	1.074	0.953	3
320	347	320_R	347_E	0.6591	1.072	0.952	27
156	166	156_A	166_A	0.6571	1.069	0.951	10
482	504	482_Y	504_T	0.6564	1.068	0.951	22
179	207	179_Q	207_N	0.6524	1.061	0.948	28
456	488	456_R	488_I	0.6507	1.058	0.947	32
490	502	490_S	502_F	0.6498	1.057	0.947	12
13	18	13_Y	18_Q	0.6491	1.056	0.947	5
155	159	155_E	159_L	0.6486	1.055	0.946	4
27	43	27_D	43_L	0.6485	1.055	0.946	16
375	394	375_G	394_A	0.6481	1.054	0.946	19
479	505	479_A	505_A	0.648	1.054	0.946	26
428	447	428_A	447_L	0.6479	1.054	0.946	19
342	373	342_H	373_Y	0.6466	1.052	0.945	31
392	396	392_S	396_S	0.6454	1.05	0.945	4
357	373	357_Y	373_Y	0.6442	1.048	0.944	16
341	360	341_G	360_A	0.6432	1.046	0.943	19
289	293	289_H	293_D	0.6416	1.043	0.942	4
359	362	359_T	362_Q	0.6402	1.041	0.941	3
134	138	134_L	138_K	0.6396	1.04	0.941	4
422	455	422_E	455_C	0.6379	1.037	0.94	33
242	274	242_Y	274_T	0.6371	1.036	0.939	32
503	519	503_H	519_L	0.6365	1.035	0.939	16
478	481	478_N	481_T	0.6346	1.032	0.938	3
9	13	9_R	13_Y	0.6346	1.032	0.938	4
354	377	354_M	377_E	0.6338	1.031	0.937	23
257	267	257_V	267_C	0.6334	1.03	0.937	10
405	427	405_M	427_D	0.6332	1.03	0.937	22
444	447	444_W	447_L	0.6321	1.028	0.936	3
345	377	345_A	377_E	0.6312	1.026	0.935	32
320	344	320_R	344_F	0.6308	1.026	0.935	24
112	115	112_S	115_K	0.6303	1.025	0.935	3
204	207	204_L	207_N	0.6302	1.025	0.935	3
512	515	512_D	515_S	0.629	1.023	0.934	3
306	319	306_G	319_A	0.627	1.02	0.933	13
465	485	465_L	485_I	0.6269	1.019	0.932	20
150	170	150_T	170_L	0.626	1.018	0.932	20
285	308	285_F	308_Y	0.626	1.018	0.932	23
483	518	483_S	518_M	0.6255	1.017	0.931	35
269	304	269_P	304_A	0.6249	1.016	0.931	35
453	484	453_H	484_A	0.6242	1.015	0.931	31
505	515	505_A	515_S	0.624	1.015	0.931	10
469	473	469_R	473_V	0.6197	1.008	0.927	4
57	83	57_A	83_A	0.619	1.007	0.927	26
251	274	251_Y	274_T	0.6189	1.007	0.927	23
154	158	154_K	158_K	0.6185	1.006	0.926	4
256	259	256_V	259_E	0.6182	1.005	0.926	3
500	504	500_D	504_T	0.6179	1.005	0.926	4
422	460	422_E	460_K	0.6168	1.003	0.925	38
325	328	325_K	328_T	0.6161	1.002	0.925	3
341	353	341_G	353_A	0.616	1.002	0.925	12
302	325	302_W	325_K	0.6143	0.999	0.923	23
317	347	317_E	347_E	0.6143	0.999	0.923	30
388	417	388_E	417_E	0.614	0.999	0.923	29
272	291	272_I	291_L	0.6134	0.998	0.923	19
503	507	503_H	507_G	0.6131	0.997	0.922	4
426	430	426_L	430_E	0.6126	0.996	0.922	4
79	83	79_C	83_A	0.611	0.994	0.921	4
60	75	60_L	75_L	0.6097	0.992	0.92	15
172	176	172_S	176_L	0.6095	0.991	0.919	4
350	377	350_H	377_E	0.6089	0.99	0.919	27
46	50	46_C	50_T	0.6076	0.988	0.918	4
351	381	351_D	381_T	0.607	0.987	0.917	30
10	26	10_V	26_A	0.6069	0.987	0.917	16
231	257	231_L	257_V	0.603	0.981	0.914	26
89	93	89_A	93_L	0.6019	0.979	0.913	4
150	173	150_T	173_H	0.6018	0.979	0.913	23
114	118	114_F	118_S	0.6005	0.977	0.912	4
342	346	342_H	346_V	0.6002	0.976	0.911	4
502	518	502_F	518_M	0.6	0.976	0.911	16
316	343	316_N	343_S	0.5991	0.974	0.91	27
358	362	358_F	362_Q	0.5987	0.974	0.91	4
448	471	448_L	471_A	0.598	0.973	0.909	23
354	374	354_M	374_I	0.5971	0.971	0.908	20
45	49	45_Q	49_L	0.5966	0.97	0.908	4
413	454	413_F	454_V	0.5956	0.969	0.907	41
272	284	272_I	284_L	0.5956	0.969	0.907	12
445	471	445_E	471_A	0.5942	0.966	0.905	26
486	498	486_G	498_A	0.5941	0.966	0.905	12
207	210	207_N	210_K	0.594	0.966	0.905	3
253	256	253_L	256_V	0.5933	0.965	0.905	3
354	381	354_M	381_T	0.5926	0.964	0.904	27
326	336	326_A	336_A	0.5925	0.964	0.904	10
371	394	371_M	394_A	0.5921	0.963	0.904	23
139	143	139_I	143_L	0.5919	0.963	0.904	4
302	326	302_W	326_A	0.5913	0.962	0.903	24
472	482	472_L	482_Y	0.591	0.961	0.902	10
320	343	320_R	343_S	0.5907	0.961	0.902	23
472	481	472_L	481_T	0.5903	0.96	0.902	9
285	305	285_F	305_V	0.5897	0.959	0.901	20
130	156	130_S	156_A	0.5896	0.959	0.901	26
268	291	268_L	291_L	0.5892	0.958	0.901	23
325	329	325_K	329_L	0.5878	0.956	0.899	4
409	421	409_G	421_A	0.5872	0.955	0.899	12
337	359	337_W	359_T	0.5864	0.954	0.898	22
453	457	453_H	457_K	0.5857	0.953	0.897	4
150	174	150_T	174_H	0.585	0.951	0.896	24
483	487	483_S	487_Y	0.5822	0.947	0.894	4
401	404	401_D	404_V	0.5802	0.944	0.892	3
501	504	501_Y	504_T	0.5797	0.943	0.891	3
310	323	310_L	323_L	0.5792	0.942	0.89	13
368	394	368_H	394_A	0.5783	0.94	0.889	26
273	277	273_G	277_E	0.5759	0.937	0.887	4
388	411	388_E	411_V	0.5754	0.936	0.886	23
422	458	422_E	458_L	0.5749	0.935	0.886	36
517	520	517_T	520_G	0.5748	0.935	0.886	3
523	529	523_I	529_D	0.5745	0.934	0.885	6
488	492	488_I	492_M	0.5743	0.934	0.885	4
406	410	406_H	410_V	0.5743	0.934	0.885	4
450	453	450_N	453_H	0.5737	0.933	0.884	3
251	278	251_Y	278_L	0.5737	0.933	0.884	27
240	244	240_R	244_N	0.5736	0.933	0.884	4
276	288	276_V	288_S	0.5732	0.932	0.883	12
398	401	398_A	401_D	0.5731	0.932	0.883	3
324	328	324_S	328_T	0.5725	0.931	0.883	4
95	98	95_M	98_P	0.5723	0.931	0.883	3
385	415	385_K	415_N	0.5722	0.931	0.883	30
379	411	379_G	411_V	0.5718	0.93	0.882	32
405	428	405_M	428_A	0.5717	0.93	0.882	23
284	308	284_L	308_Y	0.5715	0.93	0.882	24
465	494	465_L	494_N	0.5714	0.929	0.881	29
133	156	133_C	156_A	0.571	0.929	0.881	23
319	343	319_A	343_S	0.5702	0.927	0.88	24
70	74	70_E	74_Y	0.57	0.927	0.88	4
407	410	407_E	410_V	0.5696	0.926	0.879	3
320	349	320_R	349_E	0.5695	0.926	0.879	29
449	453	449_N	453_H	0.5681	0.924	0.878	4
350	381	350_H	381_T	0.5677	0.923	0.877	31
141	153	141_D	153_Y	0.5673	0.923	0.877	12
483	515	483_S	515_S	0.5658	0.92	0.875	32
41	75	41_Y	75_L	0.5657	0.92	0.875	34
452	464	452_G	464_A	0.5652	0.919	0.874	12
130	134	130_S	134_L	0.5648	0.919	0.874	4
490	495	490_S	495_F	0.5645	0.918	0.873	5
268	290	268_L	290_K	0.5642	0.918	0.873	22
29	39	29_V	39_D	0.5641	0.917	0.872	10
235	270	235_V	270_V	0.5636	0.917	0.872	35
73	96	73_R	96_E	0.5621	0.914	0.87	23
11	15	11_R	15_D	0.5619	0.914	0.87	4
239	270	239_E	270_V	0.5615	0.913	0.869	31
152	155	152_S	155_E	0.5615	0.913	0.869	3
54	83	54_H	83_A	0.5611	0.913	0.869	29
94	98	94_D	98_P	0.5607	0.912	0.869	4
247	274	247_F	274_T	0.5606	0.912	0.869	27
422	454	422_E	454_V	0.5601	0.911	0.868	32
392	420	392_S	420_T	0.5598	0.91	0.867	28
456	468	456_R	468_H	0.559	0.909	0.866	12
258	268	258_M	268_L	0.556	0.904	0.862	10
390	393	390_F	393_Q	0.5557	0.904	0.862	3
499	522	499_V	522_C	0.5554	0.903	0.861	23
423	427	423_K	427_D	0.5553	0.903	0.861	4
40	62	40_I	62_S	0.5553	0.903	0.861	22
264	267	264_H	267_C	0.5548	0.902	0.86	3
235	239	235_V	239_E	0.5545	0.902	0.86	4
426	463	426_L	463_E	0.5535	0.9	0.859	37
418	454	418_W	454_V	0.5534	0.9	0.859	36
138	169	138_K	169_L	0.5534	0.9	0.859	31
92	95	92_V	95_M	0.5532	0.9	0.859	3
487	491	487_Y	491_L	0.5527	0.899	0.858	4
26	42	26_A	42_W	0.5524	0.898	0.857	16
248	278	248_K	278_L	0.5519	0.898	0.857	30
304	307	304_A	307_C	0.5506	0.895	0.855	3
270	273	270_V	273_G	0.5458	0.888	0.849	3
322	325	322_Y	325_K	0.5458	0.888	0.849	3
402	428	402_P	428_A	0.5444	0.885	0.846	26
156	159	156_A	159_L	0.5439	0.885	0.846	3
45	75	45_Q	75_L	0.5435	0.884	0.845	30
475	478	475_I	478_N	0.5434	0.884	0.845	3
44	56	44_A	56_A	0.5428	0.883	0.844	12
151	155	151_Y	155_E	0.5426	0.882	0.843	4
281	308	281_A	308_Y	0.5422	0.882	0.843	27
57	76	57_A	76_A	0.5402	0.878	0.839	19
456	461	456_R	461_Y	0.5385	0.876	0.838	5
95	99	95_M	99_I	0.5374	0.874	0.836	4
298	301	298_N	301_S	0.537	0.873	0.835	3
147	177	147_T	177_T	0.5369	0.873	0.835	30
282	312	282_N	312_V	0.5369	0.873	0.835	30
327	336	327_T	336_A	0.5364	0.872	0.834	9
27	31	27_D	31_S	0.5364	0.872	0.834	4
482	505	482_Y	505_A	0.5364	0.872	0.834	23
321	325	321_R	325_K	0.5362	0.872	0.834	4
467	470	467_Y	470_Q	0.5362	0.872	0.834	3
157	166	157_L	166_A	0.5352	0.87	0.832	9
236	239	236_S	239_E	0.5343	0.869	0.831	3
73	95	73_R	95_M	0.5342	0.869	0.831	22
411	415	411_V	415_N	0.5339	0.868	0.83	4
94	136	94_D	136_R	0.5331	0.867	0.829	42
234	257	234_V	257_V	0.5327	0.866	0.828	23
317	321	317_E	321_R	0.5326	0.866	0.828	4
419	458	419_K	458_L	0.5325	0.866	0.828	39
376	380	376_L	380_L	0.5323	0.866	0.828	4
375	387	375_G	387_A	0.5318	0.865	0.827	12
299	326	299_P	326_A	0.5313	0.864	0.826	27
372	376	372_L	376_L	0.5307	0.863	0.825	4
387	411	387_A	411_V	0.5306	0.863	0.825	24
214	217	214_K	217_E	0.5296	0.861	0.823	3
343	347	343_S	347_E	0.529	0.86	0.822	4
466	469	466_D	469_R	0.5279	0.859	0.821	3
402	444	402_P	444_W	0.5279	0.859	0.821	42
44	63	44_A	63_R	0.5279	0.859	0.821	19
57	80	57_A	80_H	0.5268	0.857	0.819	23
428	431	428_A	431_K	0.5262	0.856	0.818	3
389	392	389_R	392_S	0.5261	0.856	0.818	3
506	515	506_L	515_S	0.5245	0.853	0.815	9
306	326	306_G	326_A	0.5245	0.853	0.815	20
151	154	151_Y	154_K	0.5236	0.852	0.814	3
487	502	487_Y	502_F	0.5229	0.85	0.812	15
274	278	274_T	278_L	0.5222	0.849	0.811	4
91	95	91_D	95_M	0.522	0.849	0.811	4
334	360	334_G	360_A	0.5214	0.848	0.81	26
255	259	255_S	259_E	0.5213	0.848	0.81	4
258	267	258_M	267_C	0.5212	0.848	0.81	9
238	257	238_A	257_V	0.5209	0.847	0.809	19
424	427	424_W	427_D	0.5202	0.846	0.808	3
389	393	389_R	393_Q	0.5199	0.845	0.807	4
308	312	308_Y	312_V	0.5197	0.845	0.807	4
41	45	41_Y	45_Q	0.5196	0.845	0.807	4
327	337	327_T	337_W	0.5195	0.845	0.807	10
22	26	22_A	26_A	0.5194	0.845	0.807	4
77	89	77_A	89_A	0.5193	0.845	0.807	12
498	502	498_A	502_F	0.5188	0.844	0.805	4
276	308	276_V	308_Y	0.5185	0.843	0.804	32
320	352	320_R	352_Q	0.518	0.843	0.804	32
326	329	326_A	329_L	0.5178	0.842	0.803	3
413	425	413_F	425_F	0.5172	0.841	0.802	12
499	519	499_V	519_L	0.5171	0.841	0.802	20
410	450	410_V	450_N	0.5167	0.84	0.801	40
355	359	355_A	359_T	0.5163	0.84	0.801	4
12	16	12_Q	16_Q	0.5149	0.837	0.798	4
81	93	81_Y	93_L	0.5147	0.837	0.798	12
157	167	157_L	167_F	0.5146	0.837	0.798	10
96	99	96_E	99_I	0.5144	0.837	0.798	3
141	169	141_D	169_L	0.5142	0.836	0.797	28
234	256	234_V	256_V	0.5134	0.835	0.796	22
265	291	265_A	291_L	0.5133	0.835	0.796	26
423	426	423_K	426_L	0.5124	0.833	0.793	3
141	149	141_D	149_A	0.5123	0.833	0.793	8
28	32	28_K	32_L	0.5111	0.831	0.791	4
129	132	129_K	132_I	0.5111	0.831	0.791	3
168	172	168_D	172_S	0.509	0.828	0.788	4
252	256	252_K	256_V	0.5079	0.826	0.785	4
310	339	310_L	339_A	0.5078	0.826	0.785	29
174	179	174_H	179_Q	0.5075	0.825	0.784	5
40	63	40_I	63_R	0.5073	0.825	0.784	23
395	404	395_L	404_V	0.5069	0.824	0.783	9
287	290	287_L	290_K	0.5067	0.824	0.783	3
379	391	379_G	391_F	0.5059	0.823	0.782	12
48	60	48_Y	60_L	0.5058	0.823	0.782	12
273	304	273_G	304_A	0.5042	0.82	0.778	31
248	252	248_K	252_K	0.504	0.82	0.778	4
42	45	42_W	45_Q	0.5038	0.819	0.777	3
141	146	141_D	146_R	0.5031	0.818	0.776	5
53	79	53_Y	79_C	0.503	0.818	0.776	26
211	214	211_K	214_K	0.5029	0.818	0.776	3
384	415	384_S	415_N	0.5021	0.817	0.775	31
303	307	303_F	307_C	0.5019	0.816	0.774	4
299	303	299_P	303_F	0.5014	0.816	0.774	4
7	39	7_R	39_D	0.5011	0.815	0.772	32
137	149	137_G	149_A	0.5003	0.814	0.771	12
160	163	160_D	163_C	0.4999	0.813	0.77	3
242	247	242_Y	247_F	0.4996	0.812	0.769	5
456	491	456_R	491_L	0.4994	0.812	0.769	35
113	117	113_G	117_P	0.4986	0.811	0.768	4
379	384	379_G	384_S	0.4982	0.81	0.766	5
149	153	149_A	153_Y	0.4973	0.809	0.765	4
37	63	37_P	63_R	0.4972	0.809	0.765	26
238	250	238_A	250_C	0.4972	0.809	0.765	12
418	458	418_W	458_L	0.4968	0.808	0.764	40
169	172	169_L	172_S	0.4968	0.808	0.764	3
28	31	28_K	31_S	0.4967	0.808	0.764	3
385	389	385_K	389_R	0.4966	0.808	0.764	4
419	423	419_K	423_K	0.4966	0.808	0.764	4
250	254	250_C	254_T	0.4961	0.807	0.763	4
24	27	24_F	27_D	0.4959	0.807	0.763	3
420	424	420_T	424_W	0.4955	0.806	0.761	4
36	39	36_E	39_D	0.4954	0.806	0.761	3
373	376	373_Y	376_L	0.4953	0.806	0.761	3
135	138	135_L	138_K	0.495	0.805	0.76	3
59	62	59_A	62_S	0.4948	0.805	0.76	3
48	56	48_Y	56_A	0.4932	0.802	0.756	8
345	350	345_A	350_H	0.4929	0.802	0.756	5
23	50	23_L	50_T	0.4923	0.801	0.755	27
48	75	48_Y	75_L	0.4917	0.8	0.754	27
307	310	307_C	310_L	0.4911	0.799	0.752	3
149	173	149_A	173_H	0.4911	0.799	0.752	24
469	497	469_R	497_N	0.49	0.797	0.75	28
14	46	14_L	46_C	0.4897	0.796	0.749	32
484	487	484_A	487_Y	0.4876	0.793	0.745	3
523	532	523_I	532_A	0.487	0.792	0.743	9
377	381	377_E	381_T	0.487	0.792	0.743	4
58	62	58_H	62_S	0.4859	0.79	0.741	4
134	163	134_L	163_C	0.4858	0.79	0.741	29
345	357	345_A	357_Y	0.4857	0.79	0.741	12
410	414	410_V	414_Q	0.4857	0.79	0.741	4
316	347	316_N	347_E	0.4856	0.79	0.741	31
419	422	419_K	422_E	0.4845	0.788	0.738	3
257	260	257_V	260_K	0.4845	0.788	0.738	3
376	391	376_L	391_F	0.4839	0.787	0.737	15
361	371	361_A	371_M	0.4819	0.784	0.733	10
286	290	286_Y	290_K	0.481	0.782	0.73	4
269	273	269_P	273_G	0.4809	0.782	0.73	4
483	512	483_S	512_D	0.4803	0.781	0.729	29
57	79	57_A	79_C	0.48	0.781	0.729	22
86	90	86_H	90_L	0.4795	0.78	0.727	4
334	338	334_G	338_I	0.4792	0.779	0.726	4
490	498	490_S	498_A	0.4787	0.778	0.725	8
152	156	152_S	156_A	0.4781	0.778	0.725	4
281	311	281_A	311_M	0.4781	0.778	0.725	30
464	468	464_A	468_H	0.478	0.777	0.723	4
168	171	168_D	171_T	0.4776	0.777	0.723	3
395	405	395_L	405_M	0.4775	0.777	0.723	10
497	501	497_N	501_Y	0.4772	0.776	0.722	4
445	478	445_E	478_N	0.4764	0.775	0.721	33
146	173	146_R	173_H	0.4764	0.775	0.721	27
285	315	285_F	315_K	0.4764	0.775	0.721	30
13	21	13_Y	21_S	0.4763	0.775	0.721	8
141	173	141_D	173_H	0.4762	0.774	0.719	32
310	316	310_L	316_N	0.476	0.774	0.719	6
303	333	303_F	333_Y	0.4751	0.773	0.718	30
295	298	295_Y	298_N	0.4742	0.771	0.715	3
356	359	356_A	359_T	0.4741	0.771	0.715	3
242	250	242_Y	250_C	0.4738	0.771	0.715	8
39	42	39_D	42_W	0.4733	0.77	0.714	3
517	521	517_T	521_H	0.4728	0.769	0.712	4
91	94	91_D	94_D	0.4719	0.768	0.711	3
341	356	341_G	356_A	0.4716	0.767	0.709	15
48	79	48_Y	79_C	0.4715	0.767	0.709	31
74	78	74_Y	78_R	0.4712	0.766	0.708	4
368	401	368_H	401_D	0.4708	0.766	0.708	33
375	390	375_G	390_F	0.4691	0.763	0.704	15
33	36	33_S	36_E	0.4688	0.762	0.702	3
524	533	524_E	533_Y	0.4686	0.762	0.702	9
276	304	276_V	304_A	0.4684	0.762	0.702	28
268	294	268_L	294_L	0.4677	0.761	0.701	26
506	516	506_L	516_V	0.4677	0.761	0.701	10
394	397	394_A	397_I	0.4676	0.76	0.699	3
73	99	73_R	99_I	0.4666	0.759	0.698	26
299	333	299_P	333_Y	0.4666	0.759	0.698	34
351	355	351_D	355_A	0.4645	0.755	0.692	4
464	488	464_A	488_I	0.4641	0.755	0.692	24
330	333	330_E	333_Y	0.4636	0.754	0.691	3
364	367	364_M	367_C	0.463	0.753	0.689	3
456	484	456_R	484_A	0.4629	0.753	0.689	28
23	47	23_L	47_L	0.4625	0.752	0.688	24
379	407	379_G	407_E	0.4609	0.75	0.685	28
361	370	361_A	370_P	0.4608	0.749	0.683	9
231	235	231_L	235_V	0.4606	0.749	0.683	4
461	492	461_Y	492_M	0.4593	0.747	0.68	31
24	28	24_F	28_K	0.4592	0.747	0.68	4
337	363	337_W	363_L	0.4592	0.747	0.68	26
453	456	453_H	456_R	0.4591	0.747	0.68	3
454	458	454_V	458_L	0.4586	0.746	0.679	4
19	46	19_Y	46_C	0.4585	0.746	0.679	27
56	79	56_A	79_C	0.4573	0.744	0.676	23
138	153	138_K	153_Y	0.457	0.743	0.674	15
146	150	146_R	150_T	0.4566	0.743	0.674	4
234	260	234_V	260_K	0.4561	0.742	0.673	26
367	370	367_C	370_P	0.4559	0.741	0.671	3
410	425	410_V	425_F	0.4556	0.741	0.671	15
385	388	385_K	388_E	0.4556	0.741	0.671	3
291	301	291_L	301_S	0.4542	0.739	0.668	10
23	43	23_L	43_L	0.454	0.738	0.667	20
339	342	339_A	342_H	0.453	0.737	0.665	3
66	69	66_D	69_Y	0.4526	0.736	0.664	3
137	152	137_G	152_S	0.4525	0.736	0.664	15
71	75	71_A	75_L	0.452	0.735	0.662	4
247	277	247_F	277_E	0.4518	0.735	0.662	30
48	53	48_Y	53_Y	0.4517	0.735	0.662	5
53	57	53_Y	57_A	0.4512	0.734	0.66	4
173	177	173_H	177_T	0.4506	0.733	0.659	4
75	78	75_L	78_R	0.4498	0.731	0.656	3
468	472	468_H	472_L	0.4496	0.731	0.656	4
351	354	351_D	354_M	0.4488	0.73	0.654	3
56	60	56_A	60_L	0.4487	0.73	0.654	4
153	157	153_Y	157_L	0.4481	0.729	0.653	4
251	280	251_Y	280_K	0.4478	0.728	0.651	29
524	530	524_E	530_S	0.4474	0.728	0.651	6
302	329	302_W	329_L	0.4471	0.727	0.65	27
487	490	487_Y	490_S	0.4465	0.726	0.648	3
255	283	255_S	283_E	0.4463	0.726	0.648	28
306	322	306_G	322_Y	0.4456	0.725	0.647	16
242	254	242_Y	254_T	0.4441	0.722	0.642	12
392	395	392_S	395_L	0.4434	0.721	0.64	3
138	141	138_K	141_D	0.4426	0.72	0.639	3
500	503	500_D	503_H	0.4417	0.718	0.635	3
499	523	499_V	523_I	0.4413	0.718	0.635	24
92	96	92_V	96_E	0.4412	0.718	0.635	4
481	484	481_T	484_A	0.4411	0.717	0.634	3
375	407	375_G	407_E	0.4407	0.717	0.634	32
461	488	461_Y	488_I	0.4405	0.716	0.632	27
247	278	247_F	278_L	0.4402	0.716	0.632	31
384	388	384_S	388_E	0.4398	0.715	0.631	4
19	23	19_Y	23_L	0.4393	0.715	0.631	4
37	41	37_P	41_Y	0.4384	0.713	0.627	4
487	518	487_Y	518_M	0.4384	0.713	0.627	31
261	264	261_D	264_H	0.4381	0.712	0.626	3
288	357	288_S	357_Y	0.4374	0.711	0.624	69
432	444	432_I	444_W	0.4374	0.711	0.624	12
59	63	59_A	63_R	0.4372	0.711	0.624	4
276	281	276_V	281_A	0.4362	0.709	0.621	5
360	363	360_A	363_L	0.4359	0.709	0.621	3
238	270	238_A	270_V	0.4356	0.708	0.619	32
38	42	38_Q	42_W	0.4355	0.708	0.619	4
87	91	87_Q	91_D	0.4353	0.708	0.619	4
286	289	286_Y	289_H	0.4349	0.707	0.618	3
316	320	316_N	320_R	0.4345	0.707	0.618	4
463	467	463_E	467_Y	0.4342	0.706	0.616	4
413	418	413_F	418_W	0.4333	0.705	0.615	5
421	454	421_A	454_V	0.4328	0.704	0.613	33
342	345	342_H	345_A	0.4327	0.704	0.613	3
300	304	300_V	304_A	0.4325	0.703	0.611	4
147	151	147_T	151_Y	0.4318	0.702	0.61	4
282	286	282_N	286_Y	0.4317	0.702	0.61	4
338	342	338_I	342_H	0.4315	0.702	0.61	4
449	478	449_N	478_N	0.431	0.701	0.608	29
20	24	20_Q	24_F	0.4309	0.701	0.608	4
379	387	379_G	387_A	0.4308	0.701	0.608	8
291	294	291_L	294_L	0.4303	0.7	0.606	3
317	320	317_E	320_R	0.4303	0.7	0.606	3
242	270	242_Y	270_V	0.4301	0.7	0.606	28
448	474	448_L	474_L	0.4295	0.698	0.603	26
413	421	413_F	421_A	0.4293	0.698	0.603	8
93	97	93_L	97_E	0.4292	0.698	0.603	4
258	290	258_M	290_K	0.4291	0.698	0.603	32
495	499	495_F	499_V	0.4286	0.697	0.601	4
480	484	480_S	484_A	0.428	0.696	0.6	4
14	26	14_L	26_A	0.4276	0.695	0.598	12
532	535	532_A	535_G	0.4275	0.695	0.598	3
58	61	58_H	61_R	0.4272	0.695	0.598	3
418	422	418_W	422_E	0.4267	0.694	0.596	4
319	323	319_A	323_L	0.4266	0.694	0.596	4
446	450	446_P	450_N	0.4266	0.694	0.596	4
247	251	247_F	251_Y	0.4259	0.693	0.595	4
167	171	167_F	171_T	0.4252	0.692	0.593	4
324	352	324_S	352_Q	0.4251	0.691	0.592	28
445	475	445_E	475_I	0.4246	0.691	0.592	30
25	28	25_W	28_K	0.4243	0.69	0.59	3
486	501	486_G	501_Y	0.4236	0.689	0.588	15
252	255	252_K	255_S	0.4236	0.689	0.588	3
449	480	449_N	480_S	0.4231	0.688	0.587	31
456	464	456_R	464_A	0.4212	0.685	0.582	8
133	159	133_C	159_L	0.4211	0.685	0.582	26
292	301	292_V	301_S	0.4209	0.685	0.582	9
405	431	405_M	431_K	0.4209	0.684	0.58	26
20	50	20_Q	50_T	0.4203	0.684	0.58	30
292	302	292_V	302_W	0.4199	0.683	0.578	10
335	339	335_P	339_A	0.4199	0.683	0.578	4
81	86	81_Y	86_H	0.4198	0.683	0.578	5
386	390	386_L	390_F	0.4198	0.683	0.578	4
254	323	254_T	323_L	0.4195	0.682	0.576	69
250	274	250_C	274_T	0.4193	0.682	0.576	24
384	414	384_S	414_Q	0.4193	0.682	0.576	30
77	92	77_A	92_V	0.4181	0.68	0.573	15
81	89	81_Y	89_A	0.418	0.68	0.573	8
341	373	341_G	373_Y	0.4179	0.68	0.573	32
258	271	258_M	271_H	0.4178	0.679	0.571	13
321	324	321_R	324_S	0.4168	0.678	0.57	3
323	340	323_L	340_Y	0.4164	0.677	0.568	17
168	233	168_D	233_V	0.4155	0.676	0.566	65
345	373	345_A	373_Y	0.4155	0.676	0.566	28
23	46	23_L	46_C	0.415	0.675	0.565	23
78	81	78_R	81_Y	0.4114	0.669	0.555	3
482	508	482_Y	508_L	0.4113	0.669	0.555	26
461	464	461_Y	464_A	0.4112	0.669	0.555	3
479	509	479_A	509_R	0.4111	0.669	0.555	30
358	361	358_F	361_A	0.4108	0.668	0.553	3
272	287	272_I	287_L	0.4099	0.667	0.551	15
342	357	342_H	357_Y	0.4094	0.666	0.549	15
391	408	391_F	408_V	0.4088	0.665	0.548	17
461	491	461_Y	491_L	0.4086	0.665	0.548	30
146	177	146_R	177_T	0.4081	0.664	0.546	31
289	292	289_H	292_V	0.4078	0.663	0.544	3
289	318	289_H	318_H	0.4077	0.663	0.544	29
355	358	355_A	358_F	0.4071	0.662	0.543	3
501	505	501_Y	505_A	0.4071	0.662	0.543	4
164	168	164_F	168_D	0.4065	0.661	0.541	4
354	383	354_M	383_N	0.4059	0.66	0.539	29
131	134	131_S	134_L	0.4058	0.66	0.539	3
453	468	453_H	468_H	0.4057	0.66	0.539	15
54	58	54_H	58_H	0.4057	0.66	0.539	4
387	391	387_A	391_F	0.4056	0.66	0.539	4
475	481	475_I	481_T	0.4055	0.659	0.538	6
287	291	287_L	291_L	0.4053	0.659	0.538	4
413	457	413_F	457_K	0.4048	0.658	0.536	44
345	353	345_A	353_A	0.4047	0.658	0.536	8
462	466	462_A	466_D	0.4044	0.658	0.536	4
44	59	44_A	59_A	0.4043	0.658	0.536	15
114	140	114_F	140_Y	0.4041	0.657	0.534	26
282	285	282_N	285_F	0.4037	0.657	0.534	3
148	152	148_L	152_S	0.4032	0.656	0.532	4
483	486	483_S	486_G	0.4025	0.655	0.531	3
232	235	232_D	235_V	0.4024	0.654	0.529	3
316	346	316_N	346_V	0.402	0.654	0.529	30
284	288	284_L	288_S	0.4017	0.653	0.527	4
496	527	496_E	527_I	0.4007	0.652	0.526	31
334	367	334_G	367_C	0.4005	0.651	0.524	33
499	527	499_V	527_I	0.4002	0.651	0.524	28
502	506	502_F	506_L	0.3999	0.65	0.522	4
310	346	310_L	346_V	0.3991	0.649	0.52	36
281	285	281_A	285_F	0.3988	0.649	0.52	4
496	500	496_E	500_D	0.3983	0.648	0.519	4
306	339	306_G	339_A	0.3972	0.646	0.515	33
253	257	253_L	257_V	0.3959	0.644	0.512	4
323	327	323_L	327_T	0.3943	0.641	0.507	4
65	68	65_L	68_L	0.3942	0.641	0.507	3
354	386	354_M	386_L	0.3942	0.641	0.507	32
462	465	462_A	465_L	0.3938	0.64	0.505	3
490	518	490_S	518_M	0.3936	0.64	0.505	28
388	420	388_E	420_T	0.3931	0.639	0.503	32
230	233	230_N	233_V	0.3926	0.638	0.502	3
69	72	69_Y	72_C	0.3922	0.638	0.502	3
154	157	154_K	157_L	0.3906	0.635	0.496	3
276	284	276_V	284_L	0.3905	0.635	0.496	8
254	258	254_T	258_M	0.3902	0.635	0.496	4
352	356	352_Q	356_A	0.3902	0.635	0.496	4
307	323	307_C	323_L	0.3901	0.634	0.495	16
204	208	204_L	208_K	0.3898	0.634	0.495	4
520	533	520_G	533_Y	0.3897	0.634	0.495	13
371	397	371_M	397_I	0.3888	0.632	0.491	26
429	447	429_L	447_L	0.3875	0.63	0.488	18
409	424	409_G	424_W	0.387	0.629	0.486	15
288	308	288_S	308_Y	0.3869	0.629	0.486	20
249	253	249_M	253_L	0.3867	0.629	0.486	4
70	96	70_E	96_E	0.3856	0.627	0.483	26
499	529	499_V	529_D	0.3852	0.626	0.481	30
357	361	357_Y	361_A	0.3849	0.626	0.481	4
310	319	310_L	319_A	0.3848	0.626	0.481	9
358	386	358_F	386_L	0.3847	0.626	0.481	28
390	394	390_F	394_A	0.3845	0.625	0.479	4
186	189	186_E	189_P	0.3844	0.625	0.479	3
358	390	358_F	390_F	0.3841	0.625	0.479	32
251	283	251_Y	283_E	0.3839	0.624	0.478	32
335	338	335_P	338_I	0.3839	0.624	0.478	3
471	474	471_A	474_L	0.3834	0.624	0.478	3
418	457	418_W	457_K	0.383	0.623	0.476	39
369	373	369_L	373_Y	0.3825	0.622	0.474	4
498	522	498_A	522_C	0.3823	0.622	0.474	24
13	25	13_Y	25_W	0.3822	0.622	0.474	12
140	143	140_Y	143_L	0.3821	0.621	0.472	3
505	508	505_A	508_L	0.3818	0.621	0.472	3
418	421	418_W	421_A	0.3817	0.621	0.472	3
55	59	55_R	59_A	0.3816	0.621	0.472	4
208	212	208_K	212_Y	0.3816	0.621	0.472	4
392	424	392_S	424_W	0.3803	0.618	0.467	32
134	165	134_L	165_E	0.3802	0.618	0.467	31
376	379	376_L	379_G	0.38	0.618	0.467	3
361	393	361_A	393_Q	0.3795	0.617	0.466	32
496	499	496_E	499_V	0.3794	0.617	0.466	3
38	41	38_Q	41_Y	0.3793	0.617	0.466	3
303	335	303_F	335_P	0.379	0.616	0.464	32
94	97	94_D	97_E	0.3778	0.614	0.46	3
378	381	378_Y	381_T	0.3776	0.614	0.46	3
27	55	27_D	55_R	0.3776	0.614	0.46	28
344	347	344_F	347_E	0.3768	0.613	0.459	3
521	525	521_H	525_M	0.3767	0.613	0.459	4
516	520	516_V	520_G	0.3745	0.609	0.452	4
208	211	208_K	211_K	0.374	0.608	0.45	3
368	372	368_H	372_L	0.3736	0.608	0.45	4
410	413	410_V	413_F	0.3731	0.607	0.449	3
409	450	409_G	450_N	0.3724	0.606	0.447	41
452	467	452_G	467_Y	0.3721	0.605	0.445	15
530	533	530_S	533_Y	0.3721	0.605	0.445	3
266	270	266_S	270_V	0.3721	0.605	0.445	4
213	217	213_N	217_E	0.3714	0.604	0.443	4
379	414	379_G	414_Q	0.3712	0.604	0.443	35
334	337	334_G	337_W	0.3708	0.603	0.442	3
407	411	407_E	411_V	0.3706	0.603	0.442	4
395	427	395_L	427_D	0.3705	0.603	0.442	32
53	83	53_Y	83_A	0.3697	0.601	0.438	30
502	522	502_F	522_C	0.3693	0.601	0.438	20
422	463	422_E	463_E	0.3693	0.601	0.438	41
116	119	116_D	119_S	0.3693	0.601	0.438	3
273	307	273_G	307_C	0.3692	0.6	0.437	34
385	417	385_K	417_E	0.3691	0.6	0.437	32
469	472	469_R	472_L	0.3689	0.6	0.437	3
489	492	489_H	492_M	0.3686	0.599	0.435	3
150	177	150_T	177_T	0.3682	0.599	0.435	27
130	163	130_S	163_C	0.3677	0.598	0.433	33
324	327	324_S	327_T	0.3677	0.598	0.433	3
515	518	515_S	518_M	0.3674	0.598	0.433	3
303	326	303_F	326_A	0.3673	0.597	0.432	23
242	310	242_Y	310_L	0.367	0.597	0.432	68
23	55	23_L	55_R	0.367	0.597	0.432	32
41	44	41_Y	44_A	0.3669	0.597	0.432	3
30	39	30_A	39_D	0.3667	0.596	0.43	9
44	48	44_A	48_Y	0.3667	0.596	0.43	4
509	515	509_R	515_S	0.3659	0.595	0.428	6
